.22-caliber	caliber
.22-calibre	calibre
.22 caliber	caliber
.22 calibre	calibre
.38-caliber	caliber
.38-calibre	calibre
.38 caliber	caliber
.38 calibre	calibre
.45-caliber	caliber
.45-calibre	calibre
.45 caliber	caliber
.45 calibre	calibre
abasic	abasia
abatic	abasia
abaxially	abaxial
abbatial	abbey
abdominal	abdomen
abdominovesical	abdomen
abdominovesical	urinary bladder
aberdonian	Aberdeen
abient	abience
abiogenetic	abiogenesis
abjectly	abject
abkhaz	Abkhaz
abkhazian	Abkhazia
ablative	ablative
ably	able
abnaki	Abnaki
abnormally	abnormal
abolitionary	abolition
abomasal	abomasum
abominably	abominable
aborad	aboral
aboriginal	Aborigine
abortively	abortive
abruptly	abrupt
absently	absent
absentmindedly	absentminded
absolutely	absolute
absolutely	absolute
absolutist	absolutism
absolutistic	absolutism
abstemiously	abstemious
abstractedly	abstracted
abstractly	abstract
abstrusely	abstruse
absurdly	absurd
abundantly	abundant
abusively	abusive
abyssal	abyssal zone
academic	academia
academically	academic
acanthotic	acanthosis
acapnial	acapnia
acapnic	acapnia
acapnotic	acapnia
accelerando	accelerando
accentual	accent
acceptably	acceptable
accessional	accession
accidentally	accidental
accipitrine	Accipiter
accommodatingly	accommodating
accommodational	accommodation
acculturational	acculturation
acculturative	acculturation
accurately	accurate
accurately	accurate
accusative	accusative case
accusatorial	accuser
accusingly	accusing
acentric	centromere
acervate	acervulus
acetic	acetic acid
acetonic	acetone
acetylenic	acetylene
acetylic	acetic acid
achaean	Achaea
achenial	achene
achlorhydric	hydrochloric acid
achondritic	achondrite
achondroplastic	achondroplasia
achromatinic	achromatin
aciculate	acicula
acidimetric	acidimetry
acidotic	acidosis
acinar	acinus
acinar	acinus
acinic	acinus
acinose	acinus
acinous	acinus
acneiform	acne
acoustic	acoustics
acoustical	acoustics
acoustically	acoustic
acrocentric	centromere
acrogenic	acrogen
acrogenous	acrogen
acronymic	acronym
acronymous	acronym
across the board	across-the-board
actinic	actinism
actinometric	actinometry
actinometrical	actinometry
actinomycetal	actinomycete
actinomycetous	actinomycete
actinomycotic	actinomycosis
actively	active
actually	actual
actuarial	actuary
aculeate	aculeus
aculeated	aculeus
acutely	acute
acutely	acute
acutely	acute
acutely	sharp
ad infinitum	infinite
adactylous	adactylia
adagio	adagio
adamantine	adamant
adamantly	adamant
adaxially	adaxial
adenocarcinomatous	adenocarcinoma
adenoid	adenoid
adenoidal	adenoid
adequately	adequate
adient	adience
adjectival	adjective
adjectivally	adjectival
adjective	adjective
adjectively	adjectival
adjudicative	adjudication
adjudicatory	adjudication
administrative	administration
administratively	administrative
admirably	admirable
adnexal	adnexa
adolescent	adolescence
adonic	Adonis
adorably	adorable
adoringly	adoring
adrenal	adrenal gland
adrenal	kidney
adrenergic	epinephrine
adrenocortical	adrenal cortex
adrift	adrift
adrift	adrift
adroitly	adroit
adulterously	adulterous
advantageously	advantageous
advective	advection
adventitial	adventitia
adventuristic	adventurism
adverbial	adverb
adverbially	adverbial
adversely	adverse
advertently	advertent
aecial	aecium
aegean	Aegean
aegean	Aegean civilization
aeolian	Aeolis
aeolian	Aeolus
aeonian	eon
aerially	aerial
aeriferous	air
aerodynamic	aerodynamics
aerolitic	aerolite
aerological	aerology
aeromechanic	aeromechanics
aeromedical	aeromedicine
aeronautic	aeronautics
aeronautical	aeronautics
aerophilatelic	aerophilately
aeschylean	Aeschylus
aesculapian	Aesculapius
aesthetic	aesthetics
aesthetically	aesthetic
aetiologic	etiology
aetiologic	etiology
aetiological	etiology
aetiological	etiology
afebrile	fever
affably	affable
affectedly	affected
affectingly	affecting
affectionately	affectionate
affine	affine transformation
affirmatively	affirmative
affixal	affix
affixial	affix
afghan	Afghanistan
afghani	Afghanistan
afghanistani	Afghanistan
afoot	afoot
african	Africa
afrikaans	South Africa
afrikaner	South Africa
afro-asian	Asia
agential	agent
aggravatingly	aggravating
aggressively	aggressive
agilely	agile
agnostic	agnostic
agnostic	agnosticism
agonadal	gonad
agonal	agony
agonistic	agon
agonizingly	agonizing
agranulocytic	agranulocytosis
agraphic	agraphia
agreeably	agreeable
agricultural	agriculture
agrobiologic	agrobiology
agrobiological	agrobiology
agrologic	agrology
agrological	agrology
agronomic	agronomy
agronomical	agronomy
agrypnotic	agrypnia
aimlessly	aimless
air-breathing	breathing
alabaster	alabaster
alabastrine	alabaster
alarmingly	alarming
alaskan	Alaska
alaskan	Alaskan
albanian	Albania
albigensian	Albigenses
albigensian	Albigensianism
albinal	albinism
albinic	albinism
albinistic	albinism
albinotic	albinism
albitic	albite
albuminous	albumin
albuminuric	albuminuria
alchemic	alchemy
alchemical	alchemy
alchemistic	alchemist
alchemistical	alchemist
aldehydic	aldehyde
aldermanic	alderman
aldermanly	alderman
alertly	alert
aleuronic	aleurone
aleutian	Aleut
alexandrian	Alexander
alexic	alexia
algal	alga
algebraic	algebra
algebraical	algebra
algebraically	algebraic
algerian	Algeria
algoid	alga
algolagnic	algolagnia
algometric	algometry
algometrical	algometry
algonkian	Algonquian
algonquian	Algonquian
algonquin	Algonquian
alimentative	alimentation
alkahestic	alkahest
alkaloidal	alkaloid
alkalotic	alkalosis
alkylic	alkyl group
allantoic	allantois
allegedly	alleged
allegorically	allegorical
allegretto	allegretto
allegro	allegro
allelic	allele
allelomorphic	allelomorph
allergenic	allergen
allergic	allergy
alliaceous	Allium
allied	Allies
allied	Allies
alliteratively	alliterative
allogamous	allogamy
allographic	allograph
allomerous	allomerism
allometric	allometry
allomorphic	allomorph
allopathic	allopathy
allophonic	allophone
allotropic	allotropy
allotropical	allotropy
alluvial	alluvium
allylic	allyl group
alone	alone
aloof	aloof
alopecic	alopecia
alphabetic	alphabet
alphabetical	alphabet
alphabetically	alphabetical
alphameric	alphanumerics
alphamerical	alphanumerics
alphanumeric	alphanumerics
alphanumerical	alphanumerics
alpine	Alps
alpine	alp
alsatian	Alsace
altaic	Altaic
alternately	alternate
alternatively	alternative
altitudinal	altitude
altruistically	altruistic
alular	alula
aluminous	aluminum
alveolar	alveolar ridge
alveolar	alveolus
alvine	intestine
amalgamative	amalgamation
amaranthine	amaranth
amaurotic	amaurosis
amazingly	amazing
ambassadorial	ambassador
ambiguously	ambiguous
ambitiously	ambitious
amblyopic	amblyopia
ambrosian	Ambrose
ambulacral	ambulacrum
ambulatory	ambulation
ameban	amoeba
amebic	amoeba
ameboid	ameba
amebous	amoeba
amenorrheal	amenorrhea
amenorrheic	amenorrhea
amenorrhoeal	amenorrhea
amenorrhoeic	amenorrhea
american	America
american	America
amerind	American Indian
amerindic	American Indian
amethystine	amethyst
amharic	Amharic
amiably	amiable
amicably	amicable
aminic	amine
amino	amine
amitotic	amitosis
ammino	ammine
ammoniac	ammonia
ammoniacal	ammonia
ammoniated	ammonium
ammonitic	ammonite
amnesic	amnesia
amnestic	amnesia
amnic	amnion
amnionic	amnion
amniotic	amnion
amoeban	amoeba
amoebic	amoeba
amoeboid	ameba
amoebous	amoeba
amok	amok
amoristic	amorist
amorously	amorous
amphibian	amphibia
amphibious	amphibia
amphitheatric	amphitheater
amphitheatrical	amphitheater
amphoric	auscultation
amply	ample
amply	ample
ampullar	ampulla
ampullary	ampulla
amuck	amuck
amusingly	amusing
amygdaline	almond
amylolytic	amylolysis
anabiotic	anabiosis
anabolic	anabolism
anachronistically	anachronistic
anaclitic	anaclisis
anacoluthic	anacoluthon
anaemic	anemia
anaesthetic	anaesthesia
anaglyphic	anaglyph
anaglyphical	anaglyph
anaglyptic	anaglyph
anaglyptical	anaglyph
anagogic	anagoge
anagogical	anagoge
anagrammatic	anagram
anagrammatical	anagram
anal	anus
analogously	analogous
analphabetic	alphabet
analytic	analysis
analytically	analytic
anamnestic	anamnesis
anamorphic	anamorphosis
anamorphic	anamorphosis
anapaestic	anapaest
anapestic	anapest
anaphasic	anaphase
anaphoric	anaphora
anaphylactic	anaphylaxis
anaplastic	anaplasia
anarchically	anarchic
anarchistic	anarchism
anasarcous	anasarca
anastigmatic	anastigmat
anastomotic	anastomosis
anatomic	anatomy
anatomic	anatomy
anatomical	anatomy
anatomical	anatomy
anatomically	anatomical
ancestral	ancestor
anciently	ancient
andalusian	Andalusia
andante	andante
andean	Andes
andorran	Andorra
androgenetic	androgenesis
androgenic	androgen
androgenous	androgenesis
androgynous	androgyne
anecdotal	anecdote
anemic	anemia
anemographic	anemography
anemometric	anemometry
anemometrical	anemometry
anencephalic	anencephaly
anencephalous	anencephaly
aneroid	aneroid
anesthetic	anesthesia
anestric	anestrus
anestrous	anestrus
aneuploid	aneuploidy
aneurismal	aneurysm
aneurismatic	aneurysm
aneurysmal	aneurysm
aneurysmatic	aneurysm
angelic	angel
angelical	angel
angelically	angelic
anginal	angina
anginose	angina
anginous	angina
angiocarpic	angiocarp
angiocarpous	angiocarp
angiomatous	angioma
angiospermous	angiosperm
anglican	Anglican Church
anglo-catholic	Anglican Church
anglo-indian	India
anglo-jewish	Jew
anglo-saxon	Anglo-Saxon
anglophilic	Anglophilia
anglophobic	Anglophobia
angolan	Angola
angrily	angry
anguillan	Anguilla
anguine	snake
angular	angle
anicteric	icterus
animalistic	animalism
animatedly	animated
animatistic	animatism
animist	animism
animistic	animism
anionic	anion
aniseikonic	aniseikonia
anisogametic	anisogamete
anisogamic	anisogamy
anisogamous	anisogamy
anisometropic	anisometropia
anisotropically	anisotropic
ankylotic	ankylosis
annalistic	annals
annelid	phylum Annelida
annelidan	phylum Annelida
annexal	annexa
annexational	annexation
annoyingly	annoying
annually	annual
annunciatory	annunciation
anodal	anode
anodic	anode
anoestrous	anestrus
anomalously	anomalous
anonymously	anonymous
anoperineal	anus
anoperineal	perineum
anopheline	genus Anopheles
anorectal	anus
anorectal	rectum
anorthitic	anorthite
anosmatic	anosmia
anosmic	anosmia
anoxemic	anoxemia
anoxic	anoxia
anserine	subfamily Anserinae
antagonistically	antagonistic
antecedently	antecedent
antecubital	cubitus
antediluvial	diluvial
antediluvian	diluvial
antennal	antenna
antennary	antenna
antenuptial	wedding
anteriorly	anterior
antheridial	antheridium
anthracitic	anthracite
anthropic	human being
anthropical	human being
anthropocentric	anthropocentrism
anthropogenetic	anthropogenesis
anthropogenic	anthropogenesis
anthropological	anthropology
anthropometric	anthropometry
anthropometrical	anthropometry
anthropophagous	anthropophagus
anti-american	America
anti-semitic	anti-Semitism
antiadrenergic	epinephrine
antiapartheid	apartheid
antibacterial	bacterial
antibiotic	antibiotic
anticancer	cancer
anticlimactic	anticlimax
anticlimactical	anticlimax
anticoagulative	anticoagulant
anticyclonic	anticyclone
antidotal	antidote
antiferromagnetic	antiferromagnetism
antifungal	antifungal
antigenic	antigen
antiguan	Antigua
antimonic	antimony
antimonious	antimony
antineoplastic	neoplasm
antinomian	antinomianism
antiphonal	antiphon
antipodal	antipodes
antipodean	antipodes
antipollution	pollution
antiquarian	antiquarian
antiquarian	antique
antisatellite	satellite
antisemitic	antisemitism
antistrophic	antistrophe
antithetically	antithetic
antithyroid	thyroid
antitumor	tumor
antitumour	tumour
antitypic	antitype
antitypical	antitype
antiviral	antiviral
anuran	Anura
anuretic	anuresis
anuric	anuresis
anxiolytic	anxiety
anxiously	anxious
aoristic	aorist
aortal	aorta
aortic	aorta
apathetically	apathetic
aphaeretic	aphaeresis
aphakic	aphakia
aphanitic	aphanite
aphasic	aphasia
apheretic	aphaeresis
aphetic	aphesis
apian	bee
apiarian	apiarist
apicultural	apiculture
aplitic	aplite
apneic	apnea
apnoeic	apnea
apocalyptic	apocalypse
apocryphal	Apocrypha
apocynaceous	Apocynaceae
apogametic	apogamy
apogamic	apogamy
apogamous	apogamy
apogean	apogee
apologetically	apologetic
apomictic	apomict
apomictical	apomict
aponeurotic	aponeurosis
apopemptic	farewell
apophatic	apophatism
apophyseal	apophysis
apophyseal	apophysis
apoplectic	apoplexy
apoplectiform	apoplexy
apoplectoid	apoplexy
aposiopetic	aposiopesis
apostolic	Apostle
apostolic	pope
apostolical	Apostle
apostolical	pope
apostrophic	apostrophe
apothecial	apothecium
apothegmatic	apothegm
apothegmatical	apothegm
appalachian	Appalachia
appallingly	appalling
apparently	apparent
apparently	apparent
appealingly	appealing
appellant	appeal
appellate	appeal
appellative	noun
appendicular	appendage
appetitive	appetite
appointive	appointment
appositional	apposition
appositive	apposition
appositively	appositive
appreciably	appreciable
appreciatively	appreciative
apprehensively	apprehensive
appropriately	appropriate
appropriative	appropriation
approvingly	approving
apsidal	apse
aptitudinal	aptitude
aptly	apt
aquacultural	aquiculture
aquatic	water
aqueous	water
aquicultural	aquiculture
aquiferous	aquifer
arabian	Arab
arabian	Arabia
arabic	Arab
araceous	Araceae
arachnidian	class Arachnida
arachnoid	class Arachnida
aramaean	Aram
aramaic	Aramaic
aramean	Aram
araneidal	order Araneida
araneidan	order Araneida
arawakan	Arawak
arawakan	Arawak
arbitral	arbitration
arbitrational	arbitration
arbitrative	arbitration
arborary	tree
arboreal	tree
arborical	tree
arborous	tree
archaeologic	archeology
archaeological	archeology
archaistic	archaism
archangelic	archangel
archangelical	archangel
archdiocesan	archdiocese
archducal	archduke
arched	arch
archegonial	archegonium
archegoniate	archegonium
archeologic	archeology
archeological	archeology
archepiscopal	archbishop
archesporial	archespore
archidiaconal	archdeacon
archiepiscopal	archbishop
archipelagic	archipelago
architectonic	tectonics
architectural	architecture
architecturally	architectural
archival	archive
archly	arch
archosaurian	Archosauria
ardently	ardent
arduously	arduous
areal	area
arenicolous	sand
areolar	areola
areolate	areola
argentic	silver
argentine	Argentina
argentinian	Argentina
argentous	silver
argive	Argos
arguably	arguable
argumentatively	argumentative
aristocratically	aristocratic
aristotelean	Aristotle
aristotelian	Aristotle
aristotelic	Aristotle
arithmetic	arithmetic
arithmetical	arithmetic
arithmetically	arithmetic
armenian	Armenia
armillary	bracelet
arminian	Arminianism
armorial	arms
aroid	Araceae
aromatic	aromatic compound
arrogantly	arrogant
arsenical	arsenical
arsenious	arsenic
artefactual	artefact
arterial	artery
arteriolar	arteriole
arteriosclerotic	arteriosclerosis
arteriovenous	artery
arteriovenous	vein
artfully	artful
artfully	artful
artfully	artful
arthralgic	arthralgia
arthromeric	arthromere
arthropodal	phylum Arthropoda
arthropodan	phylum Arthropoda
arthropodous	phylum Arthropoda
arthrosporic	arthrospore
arthrosporous	arthrospore
arthurian	Arthur
articular	articulation
articulary	articulation
articulately	articulate
articulately	articulate
articulative	articulation
articulatory	articulation
artifactual	artefact
artificially	artificial
artiodactyl	order Artiodactyla
artiodactylous	order Artiodactyla
artistic	artist
artistically	artistic
artlessly	artless
artlessly	artless
arundinaceous	genus Arundinaria
aryan	Indo-European
asat	satellite
ascensional	ascension
ascetic	ascetic
ascetical	ascetic
ascetically	ascetic
ascitic	ascites
asclepiadaceous	Asclepiadaceae
ascocarpous	ascocarp
ascomycetous	ascomycete
ascosporic	ascospore
ascosporous	ascospore
asexually	asexual
ashamedly	ashamed
asian	Asia
asiatic	Asia
asleep	asleep
asleep	asleep
aspectual	aspect
asphyxiated	asphyxia
assamese	Assam
assertively	assertive
assiduously	assiduous
associational	association
associational	associationism
assuredly	assured
asteriated	asterism
asterismal	asterism
asteroidal	asteroid
astomatal	stomatal
astonishingly	astonishing
astragalar	astragal
astral	star
astrocytic	astrocyte
astrological	astrology
astronautic	astronaut
astronautic	astronautics
astronautical	astronaut
astronautical	astronautics
astronomic	astronomy
astronomical	astronomy
astronomically	astronomic
astrophysical	astrophysics
astutely	astute
asymptotic	asymptote
asymptotically	asymptotic
asynergic	asynergy
atactic	ataxia
ataxic	ataxia
ateleiotic	ateleiosis
atheist	atheism
atheistic	atheism
athenian	Athens
atheromatic	atheroma
atheromatous	atheroma
atherosclerotic	atherosclerosis
athletic	athletics
atlantic	Atlantic
atmospheric	atmosphere
atmospherical	atmosphere
atomic	atom
atonalistic	atonalism
atonally	atonal
atonic	atonicity
atrial	atrium
atrioventricular	atrium
atrioventricular	ventricle
atrociously	atrocious
atrophic	atrophy
attentional	attention
attentively	attentive
attic	Attica
attitudinal	attitude
attractively	attractive
attributively	attributive
attritional	attrition
atypically	atypical
auctorial	author
audaciously	audacious
audenesque	Auden
audibly	audible
audile	hearing
audiometric	audiometry
audiovisual	audiovisual aid
auditive	hearing
auditory	hearing
augitic	augite
augustan	Augustus
aural	aura
aural	ear
aurally	aural
auric	gold
auricular	auricle
auricular	auricle
auricular	auricle
auriculoventricular	auricle
auriculoventricular	ventricle
auroral	aurora
auroral	dawn
aurorean	dawn
aurous	gold
auscultatory	auscultation
auspiciously	auspicious
austenitic	austenite
austerely	austere
australasian	Australasia
australian	Australia
australopithecine	genus Australopithecus
austrian	Austria
austronesian	Austronesia
autacoidal	autacoid
autarchic	autocracy
autarchical	autocracy
autarkical	autocracy
authentically	authentic
authorial	author
authoritatively	authoritative
autobiographic	autobiographer
autobiographic	autobiography
autobiographical	autobiographer
autobiographical	autobiography
autocatalytic	autocatalysis
autocratically	autocratic
autocratically	autocratic
autodidactic	autodidact
autogenetic	autogenesis
autographic	autograph
autoimmune	immune response
autolytic	autolysis
automatically	automatic
automatically	automatic
automotive	automobile
autophytic	autophyte
autoplastic	autoplasty
autoradiographic	autoradiography
autosomal	autosome
autotelic	autotelism
autotomic	autotomy
autotrophic	autotroph
autotypic	autotype
auxetic	auxesis
auxinic	auxin
avariciously	avaricious
avellan	Corylus avellana
avellane	Corylus avellana
aversive	aversion
avestan	Avesta
avian	bird
avidly	avid
avifaunal	avifauna
avifaunistic	avifauna
avionic	avionics
avitaminotic	avitaminosis
avocational	avocation
avowedly	avowed
avuncular	uncle
avuncular	uncle
award-winning	win
awfully	awful
awfully	awful
awkwardly	awkward
axial	axis
axial	axis
axially	axial
axile	axis
axillary	armpit
axillary	axil
axiological	axiology
axiomatic	axiom
axiomatic	axiom
axiomatical	axiom
axiomatically	axiomatic
axonal	axon
azerbaijani	Azerbaijan
azido	azido group
azimuthal	azimuth
azo	azo group
azotemic	azotemia
azotic	azote
baboonish	baboon
babylonian	Babylon
baccate	bacca
bacchantic	bacchant
bacillar	bacillus
bacillary	bacillus
back-channel	back channel
backstage	backstage
bacteremic	bacteremia
bacterial	bacteria
bacterially	bacterial
bacterioid	bacteria
bacterioidal	bacteria
bacteriologic	bacteriology
bacteriological	bacteriology
bacteriolytic	bacteriolysis
bacteriophagic	bacteriophage
bacteriophagous	bacteriophage
bacteriostatic	bacteriostasis
bacteroid	bacteria
bacteroidal	bacteria
badly	bad
badly	bad
badly	unfavorable
bahai	Bahaism
bahamian	Bahamas
bahraini	Bahrain
baldly	bald
balefully	baleful
balletic	ballet
ballistic	ballistics
balmily	balmy
balsamic	balsam
balsamy	balsam
baltic	Baltic Sea
baltic	Baltic State
balzacian	Balzac
banefully	baneful
bangladeshi	Bangladesh
banteringly	bantering
bantoid	Bantu
bantu	Bantu
bantu-speaking	Bantu
baptismal	baptism
baptistic	Baptist Church
barbadian	Barbados
barbarously	barbarous
bardic	bard
barefacedly	barefaced
barely	bare
baric	barium
barographic	barograph
barometric	barometer
barometrical	barometer
baroque	Baroque
baroque	Baroque
barytic	baryta
basaltic	basalt
basely	base
bashfully	bashful
basidial	basidium
basidiomycetous	basidiomycete
basidiosporous	basidiospore
basilar	base
basilary	base
basilican	basilica
basinal	basin
basophilic	basophilia
batholithic	batholith
batholitic	batholith
bathyal	bathyal zone
bathymetric	bathymetry
bathymetrical	bathymetry
batrachian	Batrachia
bauxitic	bauxite
bavarian	Bavaria
bawdily	bawdy
bayesian	Bayes' theorem
beastly	beastly
beautifully	beautiful
becomingly	becoming
beethovenian	Beethoven
befittingly	befitting
behavioral	behavior
behaviorist	behaviorism
behavioristic	behaviorism
behavioural	behavior
behaviourist	behaviorism
behaviouristic	behaviorism
belarusian	Belarus
belatedly	belated
belemnitic	belemnite
belgian	Belgium
believably	believable
believably	believable
belligerently	belligerent
benedictine	Benedict
benedictine	Benedictine
benedictive	benediction
benedictory	benediction
beneficially	beneficial
beneficiary	benefice
benevolent	benevolence
benevolently	benevolent
bengali	Bengal
benignantly	benignant
benignly	benign
beninese	Benin
benthal	benthos
benthic	benthos
benthonic	benthos
bentonitic	bentonite
benzenoid	benzene
benzoic	benzoic acid
benzoic	benzoin
benzylic	benzyl group
bermudan	Bermuda
berrylike	bacca
beseechingly	beseeching
bestially	bestial
betulaceous	Betulaceae
bewilderedly	bewildered
bewitchingly	bewitching
bhutanese	Bhutan
biannually	biannual
biauricular	auricular
biaxal	axis
biaxate	axis
biaxial	axis
biblical	Bible
biblical	Bible
bibliographic	bibliography
bibliographical	bibliography
bibliolatrous	bibliolatry
bibliomaniacal	bibliomania
bibliophilic	bibliophile
bibliopolic	bibliopole
bibliothecal	bibliotheca
bibliothecarial	bibliotheca
bibliothecarial	librarian
bibliotic	bibliotics
bicapsular	capsule
bicentenary	bicentenary
bicentennial	bicentennial
bichromated	bichromate
bicipital	biceps
bicylindrical	cylinder
biedermeier	furniture
biennially	biennial
bifilar	filar
biflagellate	flagellate
bignoniaceous	Bignoniaceae
bilabial	labial
bilaterally	bilateral
bilaterally	bilateral
biliary	bile
biliary	gallbladder
bilingually	bilingual
bilious	bile
billiard	billiards
bimetallic	bimetallism
bimetallistic	bimetallism
bimillenial	bimillennium
bimolecular	molecule
bimonthly	bimonthly
bimonthly	bimonthly
bimorphemic	morphemic
binary	binary numeration system
binaurally	binaural
binocular	eye
biocatalytic	biocatalyst
biochemical	biochemistry
biochemically	biochemical
bioclimatic	bioclimatology
biogenetic	biogenesis
biogenic	biology
biogenous	biogenesis
biogeographic	biogeography
biogeographical	biogeography
biographic	biography
biographical	biography
biologic	biology
biological	biology
biologically	biological
biologistic	biologism
biomedical	biomedicine
bionic	bionics
bionomic	bionomics
bionomical	bionomics
biosynthetic	biosynthesis
biosystematic	biosystematics
biotic	life
biotitic	biotite
biotypic	biotype
bipolar	manic depressive illness
bipolar	polar
biquadratic	quartic
biradially	biradial
birefringent	birefringence
bisectional	bisection
bismarckian	Bismarck
bismuthal	bismuth
bismuthic	bismuth
bisontine	bison
bistered	bister
bistred	bister
bistroic	bistro
bitingly	biting
bitterly	bitter
bitterly	bitter
bitterly	bitter
bitumenoid	bitumen
bituminoid	bitumen
bituminous	bitumen
bivalent	valence
bivariate	variable
biweekly	biweekly
biweekly	biweekly
biyearly	biyearly
bizonal	zone
black-and-white	achromaticity
bladderlike	bladder
bladdery	bladder
bladed	blade
bladed	blade
blamelessly	blameless
blandly	bland
blankly	blank
blasphemously	blasphemous
blastemal	blastema
blastematic	blastema
blastemic	blastema
blastocoelic	blastocoel
blastodermatic	blastoderm
blastodermic	blastoderm
blastogenetic	blastogenesis
blastomeric	blastomere
blastomycotic	blastomycosis
blastoporal	blastopore
blastoporic	blastopore
blastospheric	blastosphere
blastular	blastula
blatantly	blatant
bleakly	bleak
blessedly	blessed
blindly	blind
blindly	blind
blissfully	blissful
blithely	blithe
bloodily	bloody
bloodlessly	bloodless
bluffly	bluff
bluntly	blunt
boastfully	boastful
bodily	bodily
bodily	body
boeotian	Boeotia
bogartian	Bogart
bohemian	Bohemia
boisterously	boisterous
boldly	bold
bolivian	Bolivia
bolographic	bolograph
bolometric	bolometer
bolshevik	Bolshevism
bolshevist	Bolshevism
bolshevistic	Bolshevism
bombastically	bombastic
bonnily	bonny
bony	bone
boolean	Boole
boorishly	boorish
boracic	boron
borated	borax
boreal	north
boreal	north wind
boric	boron
boringly	boring
boronic	boron
boskopoid	Boskop man
bosnian	Bosnia-Herzegovina
botanic	botany
botanical	botany
botryoid	grape
botryoidal	grape
botswanan	Botswana
bottom-dwelling	bottom-dweller
bottom-feeding	bottom-feeder
botulinal	botulinus
boundlessly	boundless
bounteously	bounteous
bountifully	bountiful
boustrophedonic	boustrophedon
bovid	genus Bos
bovine	genus Bos
boyishly	boyish
boylike	boylike
boytrose	grape
brachial	arm
brachiopod	phylum Brachiopoda
brachiopodous	phylum Brachiopoda
brachyurous	suborder Brachyura
bracteal	bract
bracteate	bract
bracted	bract
bracteolate	bracteole
brahminic	brahmin
brahminical	brahmin
branchial	branchia
branchiopod	subclass Branchiopoda
branchiopodan	subclass Branchiopoda
branchiopodous	subclass Branchiopoda
brashly	brash
brasslike	brass
brassy	brass
bravely	brave
brazen	brass
brazenly	brazen
brazilian	Brazil
breathlessly	breathless
breech-loading	breechloader
breezily	breezy
bregmatic	bregma
bridal	bridal
bridal	bride
briefly	brief
briefly	brief
brightly	bright
brilliantly	brilliant
brilliantly	brilliant
brimless	brim
brisant	brisance
briskly	brisk
britannic	British
british	Great Britain
briton	Briton
broad-mindedly	broad-minded
broadband	frequency band
broadband	network
broadly	broad
broadly	broad
brobdingnagian	Brobdingnag
bromic	bromine
bromidic	bromide
bronchial	bronchus
bronchiolar	bronchiole
bronchoscopic	bronchoscope
brotherly	brotherly
bruneian	Brunei
brusquely	brusque
brutishly	brutish
bryophytic	bryophyte
bubaline	buffalo
bubonic	bubo
buccal	cheek
bucolic	shepherd
buddhist	Buddhism
buddhistic	Buddhism
budgetary	budget
bulbaceous	bulb
bulbar	bulb
bulbed	bulb
bulgarian	Bulgaria
bulimic	bulimia
bumptiously	bumptious
bungaloid	bungalow
buoyantly	buoyant
bureaucratic	bureaucracy
bureaucratic	bureaucrat
bureaucratically	bureaucratic
bureaucratically	bureaucratic
burglarious	burglary
burlesque	burlesque
burmese	Myanmar
burrlike	burr
bursal	bursa
burundi	Burundi
burundian	Burundi
busily	busy
buteonine	genus Buteo
butyraceous	butterfat
butyric	butyric acid
buxomly	buxom
byzantine	Byzantine Empire
byzantine	Eastern Orthodox Church
cachectic	cachexia
cacodaemonic	cacodemon
cacodemonic	cacodemon
cacodylic	cacodyl group
cacogenic	cacogenics
cadastral	cadastre
cadaveric	cadaver
cadaverous	cadaver
caducean	caduceus
caecal	cecum
caecilian	family Caeciliidae
caesarean	Caesar
caesarean	caesarean
caesarian	Caesar
caesarian	caesarean
caesural	caesura
caffeinic	caffein
cagily	cagy
cairned	cairn
calcaneal	calcaneus
calcareous	calcium carbonate
calceiform	calceus
calceolate	calceus
calcic	calcium
calciferous	calcium
calcific	calcification
calcitic	calcite
calculatingly	calculating
calculous	calculus
calcuttan	Calcutta
calendric	calendar
calendrical	calendar
calico	calico
calicular	calyculus
californian	California
calisthenic	calisthenics
calligraphic	calligraphy
calligraphical	calligraphy
callithumpian	callithump
callously	callous
calmly	calm
caloric	heat
caloric	nutritionist's calorie
calorimetric	calorimetry
calumniously	calumnious
calvinist	Calvinism
calvinistic	Calvinism
calvinistical	Calvinism
calyceal	calyx
calycinal	calyx
calycine	calyx
calycled	calyculus
calycular	calyculus
calyculate	calyculus
calyptrate	calypter
calyptrate	calyptra
cambial	cambium
cambodian	Cambodia
cambrian	Cambria
cameroonian	Cameroon
campanular	campana
campanulate	campana
campanulated	campana
camphoraceous	camphor
camphoric	camphor
canadian	Canada
canalicular	canaliculus
cancroid	cancroid
candidly	candid
canicular	Canicula
canicular	canicule
canine	Canidae
canine	canine
cannibalistic	cannibal
cannibalistic	cannibalism
cannily	canny
canonic	canon
canonic	canon law
canonical	canon
canonical	canon law
canonically	canonical
canonist	canon
cantankerously	cantankerous
cantonal	Canton
capably	capable
capacitive	capacitance
capetian	Capetian dynasty
capillary	hair
capitalist	capitalism
capitalistic	capitalism
capitular	chapter
capitulary	chapter
cappadocian	Cappadocia
capriciously	capricious
capriciously	capricious
caprine	goat
capsular	capsule
capsular	capsule
captiously	captious
captivatingly	captivating
carangid	Carangidae
carbocyclic	carbon
carbolated	carbolic acid
carbonaceous	carbon
carbonic	carbon
carboniferous	Carboniferous
carboniferous	carbon
carbonous	carbon
carbonyl	carbonyl group
carbonylic	carbonyl group
carboxyl	carboxyl group
carboxylic	carboxyl group
carcinogenic	carcinoma
carcinomatous	carcinoma
cardiac	heart
cardiographic	cardiograph
cardiologic	cardiology
cardiopulmonary	heart
cardiopulmonary	lung
cardiorespiratory	heart
cardiorespiratory	respiration
cardiovascular	blood vessel
carefully	careful
carefully	careful
carelessly	careless
carelessly	careless
carinal	carina
carmelite	Carmelite
carnal	flesh
carnally	carnal
carnivorous	carnivore
carolean	Charles I
carolean	Charles II
caroline	Charlemagne
caroline	Charles I
caroline	Charles II
carolingian	Carlovingian dynasty
carolingian	Carolingian dynasty
carotid	carotid artery
carpal	carpus
carpellary	carpel
carpetbag	carpetbagger
carposporic	carpospore
carposporous	carpospore
carroty	carrot
cartesian	Descartes
carthaginian	Carthage
carthusian	Carthusian order
cartilaginous	cartilage
cartographic	cartography
cartographical	cartography
caruncular	caruncle
carunculate	caruncle
carunculated	caruncle
carunculous	caruncle
caryophyllaceous	Caryophyllaceae
cash-and-carry	cash
casually	casual
casually	casual
casuistic	casuistry
casuistic	casuistry
casuistical	casuistry
casuistical	casuistry
catabolic	catabolism
catachrestic	catachresis
catachrestical	catachresis
catalan	Catalan
catalan	Catalonia
catalatic	catalase
cataleptic	catalepsy
catalytic	catalysis
catalytically	catalytic
cataphatic	cataphatism
cataphoretic	cataphoresis
cataplastic	cataplasia
catapultian	catapult
catapultic	catapult
catarrhal	catarrh
catastrophically	catastrophic
catatonic	catatonia
catechetic	catechesis
catechetic	catechism
catechetical	catechesis
catechismal	catechism
catechistic	catechism
categorial	category
categoric	category
categorical	category
categorically	categorical
cathectic	cathexis
cathedral	cathedra
cathodic	cathode
catholic	Catholicism
cationic	cation
catkinate	catkin
catoptric	catoptrics
catoptrical	catoptrics
caucasian	Caucasus
caucasic	Caucasus
caudal	caudal
caudal	tail
caudally	caudal
causally	causal
caustically	caustic
cautiously	cautious
cavalierly	cavalier
ceaselessly	ceaseless
cecal	cecum
celebratory	celebration
celestial	Heaven
celestial	sky
celiac	abdominal cavity
celiac	celiac disease
cellular	cell
cellulosid	cellulose
celtic	Celt
cementitious	cement
cenobitic	cenobite
cenobitical	cenobite
cenogenetic	cenogenesis
cenozoic	Cenozoic
censorial	censor
centenary	century
centennial	century
centennially	centennial
centesimal	hundredth
centigrade	centigrade scale
central american	Central America
centralist	centralization
centralistic	centralization
centrally	central
centroidal	centroid
centromeric	centromere
centrosomic	centrosome
cephalic	head
cephalopod	Cephalopoda
cephalopodan	Cephalopoda
ceramic	ceramic
cercarial	cercaria
cereal	grain
cerebellar	cerebellum
cerebral	cerebrum
cerebrally	cerebral
cerebrally	cerebral
cerebrospinal	brain
cerebrospinal	spinal cord
cerebrovascular	blood vessel
cerebrovascular	brain
ceremonially	ceremonial
ceremonious	ceremony
ceremoniously	ceremonious
ceric	cerium
cerous	cerium
certainly	certain
ceruminous	cerumen
cervical	cervix
cervical	neck
cervine	deer
cesarean	cesarean
cesarian	cesarian
cetacean	Cetacea
cetaceous	Cetacea
ceylonese	Ceylon
chadian	Chad
chaetal	chaeta
chaetognathan	Chaetognatha
chaetognathous	Chaetognatha
chafflike	chaff
chaffy	chaff
chaldaean	Chaldea
chaldean	Chaldea
chaldee	Chaldea
chalky	calcium carbonate
chalybeate	iron
chancroidal	chancroid
chancrous	chancre
chaotic	chaos
chaotically	chaotic
chaotically	chaotic
characteristically	characteristic
charily	chary
charitable	charity
charitably	charitable
charmingly	charming
chartaceous	paper
chasidic	Chasidim
chasidic	Chasidism
chassidic	Chassidim
chassidic	Chassidism
chastely	chaste
chattily	chatty
chauvinistic	chauvinist
cheaply	cheap
cheaply	cheap
cheaply	cheap
chechen	Chechnya
cheekily	cheeky
cheerfully	upbeat
cheerily	cheery
chelate	chela
chelate	chelation
chelated	chelation
cheliceral	chelicera
chelicerate	chelicera
chelicerous	chelicera
cheliferous	chela
chelonian	Chelonia
chemic	chemistry
chemical	chemical
chemical	chemistry
chemically	chemical
chemically	chemical
chemiluminescent	chemiluminescence
chemoreceptive	chemoreceptor
chemotherapeutic	chemotherapy
chemotherapeutical	chemotherapy
cherty	chert
chian	Chios
chiasmal	chiasma
chiasmatic	chiasma
chiasmic	chiasma
chiefly	chief
childbearing	childbirth
childishly	childish
chilean	Chile
chimeral	Chimera
chimeric	Chimera
chimerical	Chimera
chinese	China
chintzily	chintzy
chippendale	Chippendale
chiromantic	chiromancy
chirpily	buoyant
chirpy	chirp
chitinous	chitin
chivalrously	chivalrous
chlamydial	chlamydia
chlamydial	chlamydia
chlorophyllose	chlorophyll
chlorophyllous	chlorophyll
chlorotic	chlorosis
choleraic	cholera
choragic	choragus
choral	chorus
chorally	choral
chordal	chord
chordate	Chordata
choreographic	choreography
choric	chorus
chorionic	chorion
christian	Christianity
christological	Christology
christological	Christology
chromatic	color
chromatically	chromatic
chromatinic	chromatin
chromatographic	chromatography
chromatographical	chromatography
chromatographically	chromatographic
chromosomal	chromosome
chronically	chronic
chronological	chronology
chronologically	chronological
churchillian	Churchill
churlishly	churlish
chylaceous	chyle
chylifactive	chyle
chylifactory	chyle
chyliferous	chyle
chylific	chyle
chylous	chyle
cilial	cilium
ciliary	ciliary body
ciliary	cilium
ciliary	cilium
ciliate	cilium
ciliate	cilium
cinematic	cinema
cinerary	cinerarium
circadian	day
circularly	circular
circulative	circulation
circulatory	circulation
circulatory	circulatory system
circumspectly	circumspect
circumstantially	circumstantial
cislunar	Moon
citric	citric acid
citrous	citrus
citrous	citrus
civic	citizen
civic	city
civil	citizen
civil	state
civilly	civil
clamatorial	Clamatores
clammily	clammy
clamorously	clamorous
clannishly	clannish
classical	classics
classically	classical
classicistic	classicism
classificatory	classification
clausal	clause
cleanly	clean
cleanly	clean
clearly	clear
clearly	clear
clearly	clear
cleistogamic	cleistogamy
cleistogamous	cleistogamy
clerical	clergy
clerical	clerk
cleverly	clever
client-server	computer system
climatic	climate
climatical	climate
climatically	climatic
clinical	clinic
clinically	clinical
cliquishly	cliquish
clitoral	clitoris
clitoric	clitoris
clockwise	clockwise
clonal	clone
clonic	clonus
closed-circuit	closed circuit
closely	close
closely	close
closely	close
cloven-footed	cloven foot
cloven-hoofed	cloven hoof
cloyingly	cloying
cloze	cloze procedure
clumsily	clumsy
coarsely	coarse
coastal	coast
coccal	coccus
coccygeal	coccyx
cochlear	cochlea
cockney	Cockney
cockney	cockney
coeliac	abdominal cavity
coenobitic	cenobite
coenobitical	cenobite
cogitative	cogitation
cognitive	cognition
cognitively	cognitive
coherently	coherent
coin-operated	coin machine
coincidentally	coincidental
coincidently	coincident
coital	coitus
cold-bloodedly	cold-blooded
coldly	cold
coleridgean	Coleridge
coleridgian	Coleridge
collagenic	collagen
collagenous	collagen
collarless	collar
collectedly	collected
collectively	collective
collegial	colleague
collegial	college
collegiate	college
colloidal	colloid
colloidally	colloidal
colloquially	colloquial
colombian	Colombia
colonial	colony
colonial	colony
colonic	colon
colorectal	colon
colorectal	rectum
colorimetric	colorimetry
colorimetrical	colorimetry
columbian	Columbus
comatose	coma
comb-like	comb
combatively	combative
cometary	comet
cometic	comet
comfortably	comfortable
comfortably	comfortable
comfortably	comfortable
comfortingly	comforting
comic	comedy
comically	comical
commemorating	commemoration
commemorative	commemoration
commendable	commendable
commensal	commensalism
commensally	commensal
commercial	commerce
commercially	commercial
commonly	common
communal	commune
communally	communal
communicative	communication
communist	communism
communistic	communism
compactly	compact
compactly	compact
compactly	compact
comparably	comparable
comparative	comparison
comparatively	comparative
compassionately	compassionate
compatibly	compatible
competently	competent
competitively	competitive
complacently	complacent
complainingly	complaining
completely	complete
completely	complete
complexly	complex
composedly	composed
composite	family Compositae
comprehensively	comprehensive
compulsively	compulsive
compulsorily	compulsory
computational	computation
computational	computer
computationally	computational
con brio	con brio
concavely	concave
conceitedly	conceited
conceivably	conceivable
conceptualistic	conceptualism
conceptually	conceptual
concessive	concession
concisely	concise
conclusively	conclusive
concretely	concrete
concretistic	concretism
concurrently	concurrent
condescendingly	condescending
condylar	condyle
cone-shaped	cone
conelike	cone
confidentially	confidential
confidently	confident
confidingly	confiding
configurational	configuration
conformably	conformable
confoundedly	confounded
confrontational	confrontation
confucian	Confucianism
confusedly	confused
confusingly	confusing
congeneric	congener
congenerical	congener
congenerous	congener
congenially	congenial
congestive	congestion
congolese	Congo
congregational	Congregational Church
congregational	congregation
congregationalist	Congregational Church
congressional	congress
conic	cone
conical	cone
conically	conical
conjecturally	conjectural
conjointly	conjoint
conjugal	marriage
conjugally	conjugal
conjunctival	conjunctiva
connubial	connubial
connubial	marriage
conscientiously	conscientious
consciously	conscious
consecutive	consecutive
consecutively	consecutive
consequently	consequent
consequently	consequent
considerably	considerable
considerately	considerate
consistently	consistent
consolingly	consoling
consonantal	consonant
conspecific	species
conspicuously	conspicuous
conspicuously	conspicuous
conspirative	conspiracy
conspiratorial	conspiracy
constantly	constant
constantly	constant
constitutional	constitution
constitutionally	constitutional
constrainedly	constrained
constructively	constructive
consubstantial	consubstantiation
consular	consul
consular	consulate
contagiously	contagious
contemporaneously	contemporaneous
contemptibly	contemptible
contemptuously	contemptuous
contentedly	contented
contextual	context
contextually	contextual
continental	Colony
continental	Continent
continental	continent
continually	continual
continuously	continuous
continuously	continuous
contractual	contract
contractually	contractual
contradictorily	contradictory
contrapuntal	counterpoint
contrarily	contrary
contrarily	contrary
contrastingly	contrasting
contritely	contrite
controversially	controversial
contumaciously	contumacious
contumeliously	contumelious
conveniently	convenient
conventionally	conventional
conversationally	conversational
conversely	converse
convexly	convex
convincingly	convincing
convivially	convivial
convulsively	convulsive
coolly	cool
cooperatively	cooperative
coordinately	coordinate
copiously	copious
coptic	Copt
copular	copula
copulatory	copulation
coquettishly	coquettish
cordially	cordial
cordless	cord
coreferential	coreference
corinthian	Corinth
corinthian	Corinthian order
cormose	corm
cormous	corm
corneal	cornea
cornish	Cornwall
coronary	corona
corporate	corporation
corporatist	corporatism
corpuscular	corpuscle
correlational	correlation
corruptly	corrupt
corsican	Corsica
cortical	cortex
cortically	cortical
cortico-hypothalamic	hypothalamic
corvine	crow
corymbose	corymb
cosmetically	cosmetic
cosmic	cosmos
cosmogenic	cosmogeny
cosmogonic	cosmogony
cosmogonical	cosmogony
cosmologic	cosmology
cosmologic	cosmology
cosmological	cosmology
cosmological	cosmology
costa rican	Costa Rica
costal	rib
coterminously	coterminous
counteractively	counteractive
counterclockwise	counterclockwise
counterinsurgent	counterinsurgency
counterintuitively	counterintuitive
counterrevolutionary	counterrevolution
counterterror	counterterrorism
counterterrorist	counterterrorism
courageously	courageous
courteously	courteous
covalent	covalence
covertly	covert
covetously	covetous
covetously	covetous
coyly	coy
cozily	cozy
craftily	crafty
cranial	cranium
craniometric	craniometry
craniometrical	craniometry
crazily	crazy
creakily	creaky
crease-resistant	crease
creaseproof	crease
creatively	creative
credal	creed
credibly	credible
creditably	creditable
credulously	credulous
creedal	creed
creole	Creole
creole	creole
cretaceous	Cretaceous
cretaceous	chalk
criminally	criminal
criminally	criminal
criminological	criminology
crinoid	Crinoidea
crisply	crisp
critical	criticism
critically	critical
croatian	Croatia
cromwellian	Cromwell
crookedly	crooked
cross-cultural	culture
cross-linguistic	language
cross-linguistically	cross-linguistic
cross-modal	modality
cross-ply	pneumatic tire
cross-pollinating	cross-pollination
cross-sectional	cross section
cross-sentential	sentential
crossly	cross
crosstown	crosstown
croupy	croup
crucially	crucial
cruciferous	Cruciferae
crudely	crude
crudely	crude
cruelly	cruel
crural	crus
crushingly	crushing
crustacean	Crustacea
crustaceous	Crustacea
crustaceous	crust
crustal	crust
crustose	crust
cryogenic	cryogen
cryonic	cryonics
cryptanalytic	cryptanalysis
cryptically	cryptic
cryptobiotic	cryptobiosis
cryptogamic	cryptogam
cryptogamous	cryptogam
cryptographic	cryptography
cryptographical	cryptography
cryptographically	cryptographic
cryptologic	cryptology
cryptological	cryptology
ctenoid	ctene
cuban	Cuba
cubist	cubism
cubistic	cubism
cubital	cubitus
cucurbitaceous	Cucurbitaceae
culinary	cuisine
culpably	culpable
cultural	culture
cultural	culture
cultural	culture
culturally	cultural
cum laude	cum laude
cumulatively	cumulative
cuneiform	tarsal
cunningly	cunning
cunningly	cunning
cupric	copper
cuprous	copper
curatorial	curator
curiously	curious
curiously	curious
currently	current
curricular	curriculum
currishly	currish
cursedly	cursed
cursively	cursive
cursorily	cursory
curtly	curt
curvaceously	curvaceous
cussedly	cussed
custard-like	custard
customarily	customary
cutaneal	cutis
cutaneous	cutis
cutely	cute
cuticular	cuticle
cuticular	cuticula
cuttingly	cutting
cyanobacterial	Cyanophyceae
cyanophyte	Cyanophyta
cybernetic	cybernetics
cyclic	Carnot cycle
cyclonal	cyclone
cyclonic	cyclone
cyclonic	cyclone
cyclonical	cyclone
cyclopean	Cyclops
cyclothymic	cyclothymia
cynically	cynical
cyprian	Cyprus
cyprinid	Cyprinidae
cyprinoid	Cyprinidae
cypriot	Cyprus
cypriote	Cyprus
cyrillic	Cyrillic
cystic	cyst
cystic	cyst
cytoarchitectonic	cytoarchitectonics
cytoarchitectural	cytoarchitecture
cytogenetic	cytogenetics
cytogenetical	cytogenetics
cytokinetic	cytokinesis
cytologic	cytology
cytological	cytology
cytolytic	cytolysis
cytophotometric	cytophotometry
cytophotometrically	cytophotometric
cytoplasmatic	cytoplasm
cytoplasmic	cytoplasm
cytoplasmically	cytoplasmic
cytoplastic	cytoplast
cytotoxic	cytotoxin
czarist	czar
czaristic	czar
czech	Czechoslovakia
czechoslovakian	Czechoslovakia
dacitic	dacite
dactylic	dactyl
daftly	daft
daily	daily
daintily	dainty
daintily	dainty
daisylike	daisy
dalmatian	Dalmatia
damascene	Damascus
damnably	damnable
damply	damp
dandily	dandy
dangerously	dangerous
danish	Denmark
dantean	Dante
dantesque	Dante
daringly	daring
daringly	daring
darkly	dark
darkly	dark
darwinian	Darwinism
dashingly	dashing
dauntingly	daunting
dauntlessly	dauntless
dazedly	dazed
dazzlingly	dazzling
deadly	dead
dearly	dear
dearly	dear
dearly	dear
deceitfully	deceitful
decently	decent
deceptively	deceptive
decidedly	decided
decipherably	decipherable
decisively	decisive
decisively	decisive
decisively	decisive
declarative	declarative mood
deconstructionist	deconstructionism
decoratively	decorative
decorously	decorous
deductive	deduction
deep	deep
deeply	deep
deeply	deep
defectively	defective
defenceless	defenceless
defenseless	defenseless
defensively	defensive
defensively	defensive
deferentially	deferential
deferentially	deferential
defervescent	defervescence
defiantly	defiant
deformational	deformation
deftly	deft
deftly	deft
deictic	deixis
deist	deism
deistic	deism
dejectedly	dejected
deliberately	deliberate
deliberately	deliberate
delicately	delicate
deliciously	delicious
deliciously	delicious
delightedly	delighted
delightfully	delightful
deliriously	delirious
deliriously	delirious
deliverable	delivery
delphian	Delphi
delphic	Delphi
delusively	delusive
demagogic	demagogue
demagogical	demagogue
demandingly	demanding
demeaningly	demeaning
dementedly	demented
democratic	democrat
democratically	democratic
demographic	demography
demonstrably	demonstrable
demonstratively	demonstrative
demosthenic	Demosthenes
demotic	Demotic
demurely	demure
dendritic	dendrite
denominational	denomination
denominational	denomination
denominationally	denominational
densely	dense
dental	dentistry
dental	tooth
departmental	department
departmentally	departmental
dependably	dependable
deplorably	deplorable
deprecatively	deprecative
depressingly	depressing
derisively	derisive
dermal	cuticle
dermal	cutis
dermal	dermis
dermatologic	dermatology
dermatological	dermatology
dermic	dermis
descriptively	descriptive
despairingly	despairing
desperately	desperate
desperately	desperate
despicably	despicable
despitefully	despiteful
despondently	despondent
despotic	despot
despotical	despot
destructively	destructive
determinedly	determined
determinedly	determined
detestably	detestable
detrimentally	detrimental
developmental	development
developmentally	developmental
devilishly	devilish
devilishly	devilish
deviously	devious
devotedly	devoted
devoutly	devout
deweyan	Dewey
dexterously	dexterous
dextrously	dextrous
diabetic	diabetes
diabolically	diabolic
diagnostic	diagnosis
diagonalizable	diagonal matrix
diagonally	diagonal
diagrammatically	diagrammatic
dialectal	dialect
dialectic	dialectic
dialectical	dialectic
dialectically	dialectic
diamagnetic	diamagnetism
diamantine	diamond
diametral	diameter
diametric	diameter
diametrical	diameter
diametrically	diametric
diaphoretic	diaphoresis
diaphyseal	diaphysis
diaphysial	diaphysis
diastolic	diastole
diatomic	atom
diazo	diazonium
dicarboxylic	carboxyl
dichotomously	dichotomous
dichromatic	dichromatism
dickensian	Dickens
dictatorial	dictator
dictatorially	dictatorial
dictyopteran	Dictyoptera
didactically	didactic
dietary	diet
dietetic	diet
dietetical	diet
differentiable	differential coefficient
differential	difference
differential	differentiation
differentially	differential
differently	different
diffidently	diffident
diffusely	diffuse
digestive	digestion
digital	digit
digital	digit
digitally	digital
digitally	digital
digitately	digitate
diligently	diligent
diluvial	deluge
diluvian	deluge
dimensional	dimension
dimly	dim
dimly	dim
dimorphic	dimorphism
dimorphic	dimorphism
dimorphous	dimorphism
dimorphous	dimorphism
dingily	dingy
diocesan	diocese
dionysian	Dionysus
diplomatic	diplomacy
diplomatically	diplomatic
dipolar	dipole
dipterous	Diptera
dipylon	Dipylon gate
directional	direction
directional	direction
directly	direct
directly	direct
directly	direct
direfully	direful
dirtily	dirty
disadvantageously	disadvantageous
disagreeably	disagreeable
disappointedly	disappointed
disappointingly	disappointing
disastrously	disastrous
disbelievingly	disbelieving
disciplinary	discipline
disciplinary	discipline
discomycetous	discomycete
disconcertingly	disconcerting
disconsolately	disconsolate
discontentedly	discontented
discordantly	discordant
discouragingly	discouraging
discourteously	discourteous
discreditably	discreditable
discreetly	discreet
discursively	discursive
disdainfully	disdainful
disdainfully	disdainful
disgracefully	disgraceful
disgustedly	disgusted
disgustingly	disgusting
dishonestly	dishonest
dishonorably	dishonorable
dishonorably	dishonorable
dishonorably	dishonorable
dishonourably	dishonorable
disingenuously	disingenuous
disinterestedly	disinterested
disjointedly	disjointed
disloyally	disloyal
dismally	dismal
disobediently	disobedient
disparagingly	disparaging
dispassionately	dispassionate
dispiritedly	dispirited
displeasingly	displeasing
disproportionately	disproportionate
disproportionately	disproportionate
disputatiously	disputatious
disquietingly	disquieting
disreputably	disreputable
disrespectfully	disrespectful
disruptively	disruptive
dissolutely	dissolute
distally	distal
distantly	distant
distastefully	distasteful
distastefully	distasteful
distinctively	distinctive
distinctly	distinct
distinctly	distinct
distinctly	distinct
distractedly	distracted
distressfully	distressful
distressingly	distressing
distributional	distribution
distributively	distributed
distributively	distributive
distrustfully	distrustful
disturbingly	disturbing
dithyrambic	dithyramb
divalent	valence
diversely	diverse
divertingly	diverting
divinely	divine
divisional	division
dizygotic	zygotic
dizygous	zygotic
dizzily	dizzy
djiboutian	Djibouti
doctoral	doctor
doctoral	doctorate
doctorial	doctor
doctorial	doctorate
doctrinal	doctrine
doctrinally	doctrinal
documental	document
documentary	document
doggedly	dogged
dogmatic	dogma
dogmatic	dogma
dogmatically	dogmatic
dolefully	doleful
dolomitic	dolomite
doltishly	doltish
domestic	home
domestically	domestic
domestically	domestic
domiciliary	domicile
domineeringly	domineering
dominical	Jesus
dominical	Sunday
dominican	Dominican
dominican	Dominican Republic
donatist	Donatism
donnean	Donne
donnian	Donne
dorian	Doris
doric	Doric order
dorsally	dorsal
dorsoventrally	dorsoventral
dostoevskian	Dostoevski
dostoyevskian	Dostoevski
dot-com	dot-com
dottily	dotty
double-humped	hump
doubly	double
doubtfully	doubtful
dourly	dour
dowdily	dowdy
drably	drab
draconian	Draco
draggingly	dragging
dramatic	drama
dramatically	dramatic
dramatically	dramatic
dramatically	dramatic
dramaturgic	dramaturgy
dramaturgical	dramaturgy
drastically	drastic
dreadfully	dreadful
dreadfully	dreadful
dreamily	dreamy
drearily	dreary
drily	dry
drippily	drippy
droopingly	drooping
drowsily	drowsy
drunkenly	drunken
drupaceous	drupe
dryly	dry
dualistic	dualism
dubiously	dubious
dubiously	dubious
ducal	duke
ductless	duct
dully	dull
dully	dull
duly	due
dumbly	dumb
dumbly	dumb
dumpy	dump
duodenal	duodenum
dural	dura mater
dutch	Netherlands
dutifully	dutiful
dyadic	dyad
dynamic	dynamics
dynamically	dynamic
dynastic	dynasty
dysgenic	dysgenics
dyslexic	dyslexia
dysplastic	dysplasia
dystopian	dystopia
eagerly	eager
earnestly	earnest
earthen	earth
earthy	earth
easily	easy
east african	East Africa
east german	East Germany
east indian	East Indies
east pakistani	Bangladesh
easterly	east
eastern orthodox	Orthodox Church
easy	easy
ebionite	Ebionite
ebracteate	bract
ebulliently	ebullient
eccentrically	eccentric
eccentrically	eccentric
ecclesiastic	church
ecclesiastical	church
ecclesiastically	ecclesiastic
ecologic	ecology
ecologic	ecology
ecological	ecology
ecological	ecology
ecologically	ecological
econometric	econometrics
economic	economics
economic	economy
economical	economy
economically	economic
economically	economic
economically	economic
ecstatically	ecstatic
ectodermal	ectoderm
ectodermic	ectoderm
ectopic	ectopia
ectozoan	ectozoon
ecuadorian	Ecuador
editorial	editor
editorial	editorial
editorially	editorial
educational	education
educationally	educational
edwardian	Edward VII
effectively	effective
effectively	effective
efficaciously	efficacious
efficiently	efficient
effortlessly	effortless
effusively	effusive
egotistically	egotistic
egyptian	Egypt
einsteinian	Einstein
elaborately	elaborate
electoral	election
electric	electricity
electrical	electricity
electrical	electricity
electrically	electric
electrocardiographic	electrocardiograph
electrochemical	electrochemistry
electroencephalographic	electroencephalograph
electrolytic	electrolysis
electrolytic	electrolytic capacitor
electromagnetic	electromagnetism
electromechanical	electromechanical device
electromotive	electric current
electron microscopic	electron microscopy
electronic	electron
electronic	electronics
electronically	electronic
electrophoretic	electrophoresis
electrostatic	static electricity
electrostatically	electrostatic
elegantly	elegant
elegantly	elegant
elegiac	elegy
elemental	element
elemental	elements
elementarily	elementary
elementary	elementary school
elfin	elf
elizabethan	Elizabeth
elizabethan	Elizabethan age
elocutionary	elocution
eloquently	eloquent
elysian	Elysium
embarrassingly	embarrassing
embolic	embolism
embolic	embolus
eminently	eminent
emotional	emotion
emotionally	emotional
emotionally	emotional
empathetically	empathetic
emphatically	emphatic
emphysematous	emphysema
empiric	quackery
empirical	quackery
empirically	empirical
empyreal	empyrean
empyrean	empyrean
emulous	emulation
emulously	emulous
enchantingly	enchanting
encouragingly	encouraging
encysted	cyst
endearingly	endearing
endermatic	skin
endermic	skin
endlessly	endless
endlessly	endless
endlessly	endless
endocrinal	endocrine gland
endocrine	endocrine gland
endodontic	endodontics
endogenous	endogen
endogenously	endogenous
endometrial	endometrium
endoparasitic	endoparasite
endoscopic	endoscopy
endothelial	endothelium
endovenous	vein
endozoan	endozoan
enduringly	enduring
energetically	energetic
engagingly	engaging
english	England
english	English
enigmatically	enigmatic
enjoyably	enjoyable
enolic	enol
enormously	enormous
enteral	enteron
enteral	intestine
enteric	enteron
enteric	intestine
enterprisingly	enterprising
enthrallingly	enthralling
enthusiastically	enthusiastic
entirely	entire
entomologic	entomology
entomological	entomology
entozoan	entozoon
entrepreneurial	entrepreneur
enviably	enviable
enviously	envious
environmental	ecology
environmental	environment
environmentally	environmental
enzymatic	enzyme
eolithic	Eolithic Age
eonian	eon
eosinophilic	eosinophil
eparchial	eparchy
epenthetic	epenthesis
ephesian	Ephesus
epic	epic
epical	epic
epicarpal	epicarp
epicurean	Epicurus
epicurean	epicureanism
epicyclic	epicycle
epicyclical	epicycle
epidemiologic	epidemiology
epidemiological	epidemiology
epidermal	cuticle
epidermic	cuticle
epidural	dura mater
epigastric	abdominal wall
epigastric	epigastrium
epileptic	epilepsy
epilithic	stone
epiphyseal	epiphysis
epiphysial	epiphysis
epiphytic	epiphyte
episcopal	Episcopal Church
episcopal	bishop
episcopalian	Episcopal Church
episodically	episodic
epistemic	epistemology
epistemological	epistemology
epithelial	epithelium
epitheliod	epithelium
epizoan	epizoon
eponymic	eponym
eponymous	eponym
equably	equable
equally	equal
equally	equal
equatorial	equator
equatorial	equator
equestrian	horseback riding
equestrian	knight
equine	Equidae
equine	horse
equinoctial	equator
equinoctial	equinox
equitably	equitable
equivocally	equivocal
erasmian	Erasmus
erectly	erect
eremitic	eremite
eremitical	eremite
ergonomic	ergonomics
ergotic	ergot
ergotropic	ergotropism
eritrean	Eritrea
erotically	erotic
erratically	erratic
erroneously	erroneous
eruditely	erudite
eruptive	eruption
erythematous	erythema
erythroid	erythrocyte
erythropoietic	erythropoiesis
eschatological	eschatology
eschatologically	eschatological
esophageal	esophagus
especially	especial
especially	especial
essene	Essene
essential	essence
essentially	essential
esthetic	esthetics
esthetically	esthetic
estonian	Estonia
estrogenic	estrogen
estuarial	estuary
estuarine	estuary
eternally	eternal
ethereal	ether
ethical	ethics
ethically	ethical
ethiopian	Ethiopia
ethnically	ethnic
ethnocentric	ethnocentrism
ethnographic	ethnography
ethnographical	ethnography
ethnologic	ethnology
ethnological	ethnology
etiologic	etiology
etiologic	etiology
etiological	etiology
etiological	etiology
etymological	etymology
eucaryotic	eukaryote
eucharistic	Eucharist
euclidean	Euclid
euclidian	Euclid
eudaemonic	eudemonism
eudemonic	eudemonism
eugenic	eugenics
eukaryotic	eukaryote
euphemistically	euphemistic
euphonic	euphony
euphonical	euphony
eurafrican	Africa
eurafrican	Europe
eurasian	Eurasia
eurasiatic	Eurasia
eurocentric	Eurocentrism
european	Europe
europocentric	Eurocentrism
eutherian	Eutheria
eutrophic	eutrophication
evangelical	Gospel
evangelical	evangelicalism
evangelistic	evangelism
evaporative	evaporation
evasively	evasive
even-toed	order Artiodactyla
evenly	even
evenly	even
eventually	eventual
everlastingly	everlasting
evidentiary	evidence
evidently	evident
evilly	evil
evolutionarily	evolutionary
evolutionary	evolution
exactly	exact
exactly	exact
exasperatingly	exasperating
excellently	excellent
exceptionally	exceptional
excessively	excessive
excitedly	excited
excitingly	exciting
exclusively	exclusive
excrescent	growth
excretory	excretion
excruciatingly	excruciating
excusably	excusable
executive	execution
exegetic	exegesis
exegetical	exegesis
exilic	exile
existential	existence
existential	existentialism
existentialist	existentialism
exocrine	exocrine gland
exodontic	exodontics
exorbitantly	exorbitant
expansionist	expansionism
expansively	expansive
expansively	expansive
expectantly	expectant
expediently	expedient
expeditiously	expeditious
expensively	expensive
experiential	experience
experimental	experiment
experimentally	experimental
expertly	expert
expiative	expiation
expiatory	expiation
expiratory	expiration
explicitly	explicit
explosively	explosive
exponential	exponent
exponentially	exponential
expressionist	expressionism
expressionistic	expressionism
expressly	express
exquisitely	exquisite
extemporaneously	extemporaneous
extemporarily	extemporary
extensively	extensive
externally	external
exteroceptive	exteroception
extortionately	extortionate
extracellular	cell
extradural	dura mater
extragalactic	galaxy
extralinguistic	language
extraordinarily	extraordinary
extrasystolic	extrasystole
extraterrestrial	Earth
extravagantly	extravagant
extremely	extreme
extropic	extropy
exuberantly	exuberant
exuberantly	exuberant
exultantly	exultant
exultingly	exulting
exuvial	exuviae
fabian	Fabianism
facetiously	facetious
facial	face
facial	face
facially	facial
factor analytic	factor analysis
factor analytical	factor analysis
factorial	factorial
factual	fact
factually	factual
facultative	faculty
faddily	faddy
faddishly	faddish
fahrenheit	Fahrenheit scale
faintly	faint
fairly	fair
fairly	fair
faithfully	faithful
faithlessly	faithless
falconine	falcon
falsely	false
falsely	false
falstaffian	Falstaff
falteringly	faltering
familial	family
familiarly	familiar
famously	famous
fanatically	fanatic
fancifully	fanciful
fanged	fang
farcically	farcical
fascinatingly	fascinating
fascist	fascism
fascistic	fascism
fashionably	fashionable
faster	quick
fastest	quick
fastidiously	fastidious
fastidiously	fastidious
fatalist	fatalism
fatalistic	fatalism
fatally	fatal
fatefully	fateful
fatuously	fatuous
faucal	fauces
faultily	faulty
faultlessly	faultless
faustian	Faust
favorably	favorable
fearfully	awful
fearfully	fearful
fearlessly	fearless
fearsomely	fearsome
feasibly	feasible
febrile	fever
fecklessly	feckless
fecklessly	feckless
federal	federal government
federally	federal
feebly	feeble
feebly	feeble
felicitously	felicitous
feline	cat
feminist	feminism
femoral	femur
femoral	thigh
fenestral	fenestra
fenestral	window
ferial	feria
fermentable	fermentation
ferociously	ferocious
ferric	iron
ferromagnetic	ferromagnetism
ferrous	iron
fervently	fervent
fervidly	fervid
fetal	fetus
feudal	feudalism
feudalistic	feudalism
feudally	feudal
feudatory	fealty
feverish	fever
feverishly	feverish
fiber-optic	fiber optics
fiberoptic	fiberoptics
fibre-optic	fibre optics
fibreoptic	fibreoptics
fibrillose	fibril
fibrinous	fibrin
fibrocalcific	calcific
fibrocartilaginous	fibrocartilage
fictile	pottery
fictional	fiction
fictitiously	fictitious
fictitiously	fictitious
fiducial	standard
fiducial	trust
fiduciary	trust
field-crop	field crop
fiendishly	fiendish
fiercely	fierce
fiercely	fierce
fierily	fiery
fifthly	fifth
figuratively	figurative
fijian	Fiji
filar	filament
filarial	filaria
filariid	family Filariidae
filial	offspring
filipino	Philippines
filthily	filthy
finally	final
financial	finance
financially	financial
finely	fine
finely	fine
finitely	finite
finnish	Finland
firmamental	firmament
firmly	firm
fiscal	finance
fiscally	fiscal
fisheye	fisheye lens
fishily	fishy
fishy	fish
fistulous	fistula
fitfully	fitful
fitly	fit
fixedly	fixed
flabbily	flabby
flagellate	flagellum
flagellated	flagellum
flagrantly	flagrant
flakey	flake
flaky	flake
flamboyantly	flamboyant
flashily	flashy
flashily	flashy
flatly	flat
flawlessly	flawless
fleetly	fleet
flemish	Flanders
fleshy	flesh
flexibly	flexible
flimsily	flimsy
flinty	flint
flippantly	flippant
flirtatiously	flirtatious
floral	flora
floral	flower
florentine	Florence
floricultural	floriculture
floridly	florid
flowery	flower
fluently	fluent
fluvial	river
focal	focus
focally	focal
foetal	fetus
foliaceous	leaf
foliate	foliage
foliated	foliage
follicular	follicle
fondly	fond
foolishly	foolish
forbiddingly	forbidding
forcefully	forceful
forcibly	forcible
forcipate	forceps
forgetfully	forgetful
forgivably	forgivable
forgivingly	forgiving
forlornly	forlorn
formalised	formalism
formalistic	formalism
formalized	formalism
formally	formal
formally	formal
formic	ant
formic	formic acid
formidably	formidable
formlessly	formless
formulary	formula
forte	forte
fortissimo	fortissimo
fortnightly	fortnightly
fortuitously	fortuitous
fortunately	fortunate
fossil	fossil
fossiliferous	fossil
foully	foul
four-wheel	wheel
four-wheeled	wheel
fourfold	fourfold
fourhanded	card game
fourth	fourth
fourthly	fourth
foxily	foxy
fractiously	fractious
fractiously	fractious
franciscan	Francis of Assisi
frankish	Frank
frankly	frank
frantically	frantic
fraternal	brotherhood
fraternally	fraternal
fraudulently	fraudulent
freakishly	freakish
freely	free
french	France
frenetically	frenetic
frenziedly	frenzied
frequently	frequent
freshly	fresh
fretfully	fretful
fretted	fret
freudian	Freud
frictional	friction
frictionless	friction
frighteningly	frightening
frigidly	frigid
frisian	Friesland
frisian	Frisia
friskily	frisky
frivolously	frivolous
frontal	front
frontally	frontal
frostian	Frost
frostily	frosty
frothily	frothy
frowningly	frowning
frugally	frugal
fruitlessly	fruitless
frumpily	frumpy
frumpishly	frumpish
fugal	fugue
fugally	fugal
fully	full
fulsomely	fulsome
functional	function
functionally	functional
fundamentalist	fundamentalism
fundamentalistic	fundamentalism
fundamentally	fundamental
funerary	funeral
fungal	fungus
fungicidal	fungicide
fungoid	fungus
fungous	fungus
funguslike	fungus
funicular	cable
funnily	funny
furiously	furious
furiously	furious
furiously	furious
furtively	furtive
fussily	fussy
futilely	futile
future	future
futurist	futurism
futuristic	futurism
gabonese	Gabon
gaelic	Celt
gaily	gay
gainfully	gainful
galactic	galaxy
galilaean	Galilean
galilaean	Galilee
galilean	Galilean
galilean	Galilee
galilean	Galileo
gallantly	gallant
gallic	France
gallic	Gaul
gallican	Gallicanism
gallinaceous	gallinacean
galvanic	galvanism
galwegian	Galloway
gambian	Gambia
gamely	game
gandhian	Gandhi
garishly	garish
garlicky	garlic
garrulously	garrulous
gastric	stomach
gastroduodenal	duodenum
gastroduodenal	stomach
gastroesophageal	esophagus
gastroesophageal	stomach
gastrointestinal	gastrointestinal tract
gastronomic	gastronomy
gastronomical	gastronomy
gaudily	gaudy
gauguinesque	Gauguin
gaussian	Gauss
gayly	gay
gemmiferous	gemma
genealogic	genealogy
genealogical	genealogy
genealogically	genealogical
generally	general
generally	general
generational	generation
generic	genus
generically	generic
generically	generic
generously	generous
genetic	gene
genetic	genetics
genetic	origin
genetical	gene
genetically	genetic
genial	chin
genially	genial
genic	gene
genital	genitals
genitive	genitive case
genitourinary	genital organ
genitourinary	urinary organ
genoese	Genoa
genotypic	genotype
genotypical	genotype
genovese	Genoa
genteelly	genteel
gentile	gentile
gently	gentle
gently	gentle
gently	gentle
genuinely	genuine
genuinely	genuine
geodesic	geodesy
geodesical	geodesy
geodetic	geodesy
geographic	geography
geographical	geography
geographically	geographic
geologic	geology
geological	geology
geologically	geological
geometric	geometry
geometrical	geometry
geometrically	geometric
geometrically	geometric
geomorphologic	geomorphology
geomorphological	geomorphology
geophysical	geophysics
geophytic	geophyte
geopolitical	geopolitics
georgian	George
georgian	Georgia
georgian	Georgia
georgian	Georgia
geostrategic	geostrategy
geothermal	heat
geothermally	geothermal
geothermic	heat
geriatric	aged
geriatric	geriatrics
german	Germany
german-american	German American
germanic	Germanic
germanic	Teuton
gerontological	geriatrics
gerundial	gerund
gestational	gestation
ghanaian	Ghana
ghanese	Ghana
ghanian	Ghana
gibraltarian	Gibraltar
giddily	giddy
gilbertian	Gilbert
gingerly	gingerly
gingival	gingiva
girlishly	girlish
glabellar	glabella
glacial	glacier
glacially	glacial
gladiatorial	gladiator
gladly	glad
glandular	gland
glaringly	glaring
glaswegian	Glasgow
gleefully	gleeful
glial	glia
glibly	glib
globally	global
glomerular	glomerulus
gloomily	gloomy
gloriously	glorious
glossily	glossy
glossopharyngeal	throat
glossopharyngeal	tongue
glottal	glottis
glottochronological	glottochronology
gloweringly	glowering
glowingly	glowing
glumly	glum
gluteal	gluteus
gluttonously	gluttonous
glycogenic	glycogen
gnomic	gnome
gnostic	Gnosticism
goethean	Goethe
goethian	Goethe
gonadal	gonad
gonadotrophic	gonadotrophin
gonadotropic	gonadotropin
good-naturedly	good-natured
gorgeously	gorgeous
gothic	Goth
gothic	Gothic
gothic	Gothic
governmentally	governmental
gracefully	graceful
gracefully	graceful
gracelessly	graceless
gracelessly	graceless
graciously	gracious
gradually	gradual
grammatic	grammar
grammatical	grammar
grammatically	grammatical
grandiloquently	grandiloquent
grandiosely	grandiose
grandly	grand
granuliferous	granule
granulocytic	granulocyte
granulomatous	granuloma
grapelike	grape
graphic	graph
graphic	graphics
graphical	graph
graphically	graphic
graphically	graphic
gratefully	grateful
gratefully	grateful
gratifyingly	gratifying
gratingly	grating
gratuitously	gratuitous
gravely	grave
gravely	grave
gravimetric	hydrometry
gravitational	gravitation
gravitationally	gravitational
gravitative	gravity
grayly	gray
greasily	greasy
greatly	great
grecian	Greece
greedily	greedy
greek	Greece
greek orthodox	Orthodox Church
green	Green Party
greenhouse	greenhouse effect
greenly	green
greensick	greensickness
greenside	green
gregariously	gregarious
gregorian	Gregorian calendar
gregorian	Gregorian chant
gregorian	Gregory I
gregorian	Gregory XIII
grenadian	Grenada
greyly	grey
grievously	grievous
grimly	grim
gropingly	groping
grossly	gross
grotesquely	grotesque
grouchily	grouchy
growing	growth
grubbily	grubby
grubby	grub
grudgingly	grudging
gruesomely	gruesome
gruffly	gruff
grumpily	grumpy
grungily	grungy
guardedly	guarded
guatemalan	Guatemala
gubernatorial	governor
guiltily	guilty
guinean	Guinea
gushingly	gushing
gustative	taste
gustatorial	taste
gustatory	taste
guttural	throat
gutturally	guttural
guyanese	Guyana
gymnastic	gymnastics
gymnosophical	gymnosophy
gymnospermous	Gymnospermae
gynaecological	gynecology
gynecologic	gynecology
gynecological	gynecology
gyral	gyrus
gyroscopic	gyroscope
habitually	habitual
hadal	seabed
haemal	blood vessel
haematal	blood vessel
haematic	blood
haematogenic	haematogenesis
haematological	hematology
haematopoietic	haematopoiesis
haemic	blood
haemolytic	hemolysis
haemophilic	hemophilia
haemopoietic	haemopoiesis
haemorrhagic	haemorrhage
haggardly	haggard
hair-shirt	hair shirt
hair-shirted	hair shirt
haitian	Haiti
half	half
half-and-half	half-and-half
half-heartedly	halfhearted
half-hourly	half-hourly
half-yearly	half-yearly
handelian	Handel
handily	handy
handsomely	handsome
handsomely	handsome
hanoverian	Hanover
haphazard	haphazard
haphazardly	haphazard
haphazardly	haphazard
happily	happy
happily	happy
haptic	touch
haptic	touch
haptically	haptic
hard	hard
hard	hard
hard	hardened
harmfully	harmful
harmlessly	harmless
harmonic	harmonic
harmonic	harmonics
harmonic	harmony
harmonically	harmonic
harmoniously	harmonious
harshly	harsh
harshly	harsh
hasidic	Hasidim
hasidic	Hasidism
hassidic	Hassidim
hassidic	Hassidism
hastily	hasty
hatefully	hateful
haughtily	haughty
hawaiian	Hawaii
hawaiian	Hawaii
hazardously	hazardous
hazily	hazy
hazily	hazy
head-to-head	head-to-head
headlong	headlong
healthily	healthy
heartily	hearty
heartily	hearty
heartlessly	heartless
heatedly	heated
heathlike	heath
heavenly	Heaven
heavenly	sky
heavily	heavy
heavily	heavy
heavily	heavy
heavily	heavy
heavily	heavy
heavily	heavy-duty
hebdomadally	hebdomadal
hebraic	Hebrew
hebraic	Hebrew
hebraical	Hebrew
hebraical	Hebrew
hebrew	Hebrew
hebrew	Hebrew
hebridean	Hebrides
hectically	hectic
heedfully	heedful
heedlessly	heedless
hegelian	Hegel
heinously	heinous
heliac	sun
heliacal	sun
hell-for-leather	breakneck
hellenic	Greece
hellenic	Hellenism
hellenistic	Hellenism
hellenistical	Hellenism
helpfully	helpful
helplessly	helpless
hemal	blood vessel
hematal	blood vessel
hematic	blood
hematogenic	hematogenesis
hematologic	hematology
hematological	hematology
hematopoietic	hematopoiesis
hemic	blood
hemingwayesque	Hemingway
hemiparasitic	hemiparasite
hemispheric	hemisphere
hemispherical	hemisphere
hemodynamic	hemodynamics
hemolytic	hemolysis
hemophilic	hemophilia
hemopoietic	hemopoiesis
hemorrhagic	hemorrhage
hepatic	liver
heraldic	heraldry
heraldist	heraldry
herbal	herb
hermeneutic	hermeneutics
hermetically	hermetic
heroic	hero
heroically	heroic
hertzian	Hertz
hesitantly	hesitant
heterodyne	beat
heterosporous	heterospory
hex	hexadecimal number system
hexadecimal	hexadecimal number system
hexagonal	hexagon
hexangular	hexagon
hideously	hideous
hidrotic	sweat
hierarchically	hierarchical
hieratic	hieratic
hieratic	priesthood
hieratical	priesthood
hieroglyphic	hieroglyph
hieroglyphic	hieroglyph
hieroglyphical	hieroglyph
hieroglyphical	hieroglyph
hieroglyphically	hieroglyphic
high-energy	energy
high-handedly	high-handed
high-mindedly	high-minded
highly	high
highly	high
hilar	hilum
hilariously	hilarious
himalayan	Himalayas
hinderingly	hindering
hindi	Hinduism
hindoo	Hinduism
hindu	Hinduism
hindustani	Hindustan
hiplength	hipline
hiplength	hipline
hippocratic	Hippocrates
hircine	goat
hispanic	Hispanic
hispaniolan	Haiti
histologic	histology
histological	histology
histologically	histological
historical	history
historically	historic
historically	historical
hitlerian	Hitler
hittite	Hittite
hittite	Hittite
hmong	Hmong
hoarsely	hoarse
hollywood	Hollywood
holographic	holograph
holographic	holography
holographical	holograph
home	home
homeopathic	homeopathy
homeostatic	homeostasis
homeostatically	homeostatic
homeric	Homer
homiletic	homiletics
homiletic	homily
homiletical	homiletics
homiletical	homily
homogeneously	homogeneous
homonymic	homonym
homonymous	homonym
homophonous	homophone
homosporous	homospory
homostyled	style
homostylic	style
homostylous	style
honduran	Honduras
honestly	honest
honestly	honest
honorably	honorable
hooflike	hoof
hopefully	hopeful
hopelessly	hopeless
hopelessly	hopeless
hopelessly	hopeless
horary	hour
horizontally	horizontal
hormonal	hormone
horribly	horrible
horridly	horrid
horrifyingly	horrifying
horse-drawn	horse
horticultural	horticulture
horticulturally	horticultural
hospitably	hospitable
hostilely	hostile
hotly	hot
hourly	hourly
huffily	huffy
hugoesque	Hugo
human	humanity
humane	humanities
humanely	humane
humanist	humanism
humanist	humanism
humanist	humanities
humanistic	humanism
humanistic	humanism
humanistic	humanities
humanitarian	humanitarianism
humanly	human
humbly	humble
humbly	humble
humic	humus
humified	humus
humiliatingly	humiliating
humoral	humor
humorlessly	humorless
humorously	humorous
hungarian	Hungary
hungrily	hungry
hurriedly	hurried
huskily	husky
huxleian	Huxley
huxleyan	Huxley
hyaloplasmic	hyaloplasm
hydraulic	hydraulics
hydraulic	water
hydraulically	hydraulic
hydrocephalic	hydrocephalus
hydrodynamic	hydrodynamics
hydroelectric	hydroelectricity
hydrographic	hydrography
hydrographical	hydrography
hydrokinetic	hydrokinetics
hydrolyzable	hydrolysis
hydrometric	hydrometry
hydropathic	hydropathy
hydroponic	aquiculture
hydrostatic	hydrostatics
hydroxy	hydroxyl
hygienically	hygienic
hymenal	hymen
hymeneal	marriage
hymeneal	wedding
hymenopterous	Hymenoptera
hyoid	hyoid bone
hyperbolic	hyperbola
hyperbolically	hyperbolic
hyperemic	hyperemia
hyperthermal	hyperthermia
hypnotic	hypnosis
hypnotically	hypnotic
hypocritically	hypocritical
hypodermal	hypodermis
hypodermic	skin
hypoglycaemic	hypoglycaemia
hypoglycemic	hypoglycemia
hypophyseal	hypophysis
hypophysial	hypophysis
hypothalamic	hypothalamus
hypothalamically	hypothalamic
hypothermic	hypothermia
hypothetically	hypothetical
hypovolaemic	hypovolaemia
hypovolemic	hypovolemia
hysterically	hysterical
iambic	iamb
iberian	Iberia
ibsenian	Ibsen
icelandic	Iceland
ichorous	ichor
icily	icy
iconic	icon
icosahedral	icosahedron
ictal	ictus
icterogenic	icterus
ictic	ictus
ideal	idealism
idealistic	idealism
ideally	ideal
identically	identical
identifiably	identifiable
ideographic	ideograph
ideographically	ideographic
ideological	ideology
idiomatic	idiom
idiomatical	idiom
idiomatically	idiomatic
idiopathic	idiopathy
idiotically	idiotic
idly	idle
idolatrous	idolatry
idolatrously	idolatrous
idyllically	idyllic
igneous	heat
ignobly	ignoble
ignominiously	ignominious
ignorantly	ignorant
iliac	ilium
illative	inference
illegally	illegal
illegibly	illegible
illegitimately	illegitimate
illiberally	illiberal
illicitly	illicit
illicitly	illicit
illogically	illogical
illustriously	illustrious
imaginatively	imaginative
immaculately	immaculate
immaturely	immature
immeasurably	immeasurable
immeasurably	immeasurable
immediately	immediate
immediately	immediate
immediately	immediate
immensely	immense
imminently	imminent
immoderately	immoderate
immoderately	immoderate
immodestly	immodest
immorally	immoral
immovably	immovable
immune	immunity
immunochemical	immunochemistry
immunocompromised	immunological disorder
immunologic	immunology
immunological	immunology
immunologically	immunological
immunosuppressed	immunosuppression
immunosuppressive	immunosuppression
immunotherapeutic	immunotherapy
immutably	immutable
impartially	impartial
impassively	impassive
impatiently	impatient
impeccably	impeccable
impenitently	impenitent
imperative	imperative mood
imperatively	imperative
imperceptibly	imperceptible
imperfectly	imperfect
imperial	British Imperial System
imperial	emperor
imperial	empire
imperialist	imperialism
imperialistic	imperialism
imperially	imperial
imperiously	imperious
impermissibly	impermissible
impersonally	impersonal
impersonally	impersonal
impertinently	impertinent
impetiginous	impetigo
impetuously	impetuous
impiously	impious
impishly	impish
implausibly	implausible
implicational	implication
implicitly	implicit
implicitly	implicit
impolitely	impolite
importantly	important
importantly	important
importunately	importunate
imposingly	imposing
impossibly	impossible
impotently	impotent
impracticably	impracticable
imprecisely	imprecise
impregnably	impregnable
impressionist	Impressionism
impressionistic	Impressionism
impressionistic	impression
impressively	impressive
improbably	improbable
improperly	improper
improvidently	improvident
imprudently	imprudent
impudently	impudent
impulsively	impulsive
in vitro	in vitro
in vivo	in vivo
inaccessibly	inaccessible
inaccurately	inaccurate
inadequately	inadequate
inadvertently	inadvertent
inadvisably	inadvisable
inalienably	inalienable
inanely	inane
inappropriately	inappropriate
inarticulately	inarticulate
inarticulately	inarticulate
inattentively	inattentive
inaudibly	inaudible
inaugurally	inaugural
inauspiciously	inauspicious
incan	Inca
incautiously	incautious
incendiary	arson
incessantly	incessant
incessantly	incessant
incestuous	incest
incestuous	intimacy
incestuously	incestuous
incident	incidence
incidentally	incidental
incisively	incisive
incoherently	incoherent
incomparably	incomparable
incompatibly	incompatible
incompetently	incompetent
incompletely	incomplete
inconceivably	inconceivable
inconclusively	inconclusive
incongruously	incongruous
inconsequently	inconsequent
inconsiderately	inconsiderate
inconsistently	inconsistent
inconspicuously	inconspicuous
incontrovertibly	incontrovertible
inconveniently	inconvenient
incorrectly	incorrect
incorrectly	incorrect
increasingly	increasing
incredibly	incredible
incredulously	incredulous
incriminatingly	incriminating
incurably	incurable
incurably	incurable
indecently	indecent
indecisively	indecisive
indecisively	indecisive
indecorously	indecorous
indefatigably	indefatigable
indefinitely	indefinite
indelibly	indelible
independently	independent
indescribably	indescribable
indeterminably	indeterminable
indexical	index
indexless	index
indian	American Indian
indian	India
indicative	indicative mood
indifferently	indifferent
indigenously	indigenous
indignantly	indignant
indirectly	indirect
indiscreetly	discreet
indiscriminately	indiscriminate
indiscriminately	indiscriminate
indistinctly	indistinct
individualistically	individualistic
individually	individual
indo-aryan	Indo-European
indo-european	Indo-European
indo-european	Indo-European
indo-germanic	Indo-European
indolently	indolent
indonesian	Indonesia
indubitably	indubitable
inductive	inductance
indulgently	indulgent
indusial	indusium
industrial	industry
industrially	industrial
industriously	industrious
ineffably	ineffable
ineffectively	ineffective
ineffectually	ineffectual
inefficaciously	inefficacious
inefficiently	inefficient
inelegantly	inelegant
ineluctably	ineluctable
ineptly	inept
ineptly	inept
inequitably	inequitable
inertial	inertia
inescapably	inescapable
inevitably	inevitable
inevitably	inevitable
inexactly	inexact
inexcusably	excusable
inexcusably	inexcusable
inexorably	inexorable
inexpediently	inexpedient
inexpertly	inexpert
inextricably	inextricable
infantile	infancy
infectious	infection
infectiously	infectious
infelicitously	infelicitous
inferential	inference
infernal	inferno
infernal	inferno
infernally	infernal
infinitely	infinite
infinitival	infinitive
inflexibly	inflexible
influentially	influential
informally	informal
informally	informal
informational	information
informatively	informative
inframaxillary	mandible
infrequently	infrequent
ingenuously	ingenuous
ingloriously	inglorious
ingratiatingly	ingratiating
inguinal	inguen
inhalant	inhalation
inherently	inherent
inhospitably	inhospitable
inhumanely	inhumane
inimitably	inimitable
iniquitously	iniquitous
initially	initial
injudiciously	injudicious
injuriously	injurious
ink-jet	ink-jet printer
innately	innate
innocently	innocent
innocently	innocent
inoffensively	inoffensive
inopportunely	inopportune
inordinately	inordinate
inorganically	inorganic
inquiringly	inquiring
inquisitively	inquisitive
inquisitorial	inquisitor
insanely	insane
insatiably	insatiable
insatiably	insatiable
inscriptive	inscription
inscriptively	inscriptive
inscrutably	inscrutable
insectan	insect
insecticidal	insecticide
insecticidally	insecticidal
insecurely	insecure
insecurely	insecure
insensately	insensate
insensibly	insensible
insensitively	insensitive
inseparably	inseparable
insidiously	insidious
insignificantly	insignificant
insignificantly	insignificant
insincerely	insincere
insipidly	insipid
insistently	insistent
insolently	insolent
inspirationally	inspirational
inspiratory	inhalation
instantaneously	instantaneous
instinctively	instinctive
institutional	institution
institutionally	institutional
instructional	instruction
instructively	instructive
instrumental	musical instrument
insufficiently	insufficient
insular	island
insultingly	insulting
insuperably	insuperable
insurrectional	insurrection
insurrectionary	insurrection
integral	integer
integrally	integral
integumental	integument
integumentary	integument
intellectually	intellectual
intelligently	intelligent
intelligibly	intelligible
intemperately	intemperate
intensely	intense
intensive	intensifier
intensively	intense
intentionally	intentional
intently	intent
intercellular	cell
interchangeably	interchangeable
intercostal	rib
interdepartmental	department
interdepartmental	interdepartmental
interdisciplinary	discipline
interest-bearing	interest
interestingly	interesting
interfacial	interface
intergalactic	galaxy
interlineal	line
interlinear	line
interlobular	lobular
interlocutory	dialogue
interminably	interminable
intermittently	intermittent
intermolecular	molecule
internally	internal
internationally	international
interoceptive	interoception
interplanetary	planet
interracially	interracial
interrogative	interrogative mood
interrogatively	interrogative
interstellar	star
interstitial	interstice
intertidal	littoral
intertribal	tribe
intervertebral	vertebra
intestinal	intestine
intimal	intima
intimately	intimate
intolerably	tolerable
intolerantly	intolerant
intolerantly	intolerant
intracellular	cell
intracerebral	cerebrum
intracranial	cranial
intractably	intractable
intracutaneous	skin
intradepartmental	department
intradermal	skin
intradermally	intradermal
intradermic	skin
intralinguistic	language
intralobular	lobular
intramolecular	molecule
intramuscular	muscle
intramuscularly	intramuscular
intransitively	intransitive
intrapulmonary	lung
intrasentential	sentential
intrauterine	uterine
intravenous	vein
intravenously	intravenous
intraventricular	ventricle
intrepidly	intrepid
intricately	intricate
intrinsically	intrinsic
intuitionist	intuitionism
intuitively	intuitive
invariably	invariable
inventively	inventive
inversely	reciprocal
invidiously	invidious
invincibly	invincible
invisibly	invisible
invitational	invitation
invitingly	inviting
involucrate	involucre
involuntarily	involuntary
inwardly	inward
iodinated	iodine
iodised	iodine
iodized	iodine
ionian	Attica
ionic	Ionia
ionic	Ionic order
ionic	ion
iraki	Iraq
iranian	Iran
iraqi	Iraq
irately	irate
iridaceous	Iridaceae
iridic	iridium
iridic	iris
irish	Ireland
iritic	iris
ironically	ironical
irrational	ratio
irrationally	irrational
irregularly	irregular
irregularly	irregular
irregularly	irregular
irrelevantly	irrelevant
irreparably	irreparable
irreproachably	irreproachable
irresistibly	irresistible
irresolutely	irresolute
irresponsibly	irresponsible
irretrievably	irretrievable
irreverently	irreverent
irreverently	irreverent
irreversibly	irreversible
irrevocably	irrevocable
irritably	irritable
irritably	irritable
irritatingly	irritating
ischaemic	ischaemia
ischemic	ischemia
isentropic	entropy
islamic	Islamism
ismaili	Ismailism
isolationist	isolationism
isolationistic	isolationism
isomeric	isomerism
isometric	isometry
isomorphic	isomorphism
isomorphous	isomorphism
isopteran	Isoptera
isothermic	isotherm
isotonic	tone
isotopic	isotope
isotropically	isotropic
israeli	Israel
isthmian	isthmus
italian	Italy
italic	Italic
italic	italic
jacksonian	Andrew Jackson
jacobean	James I
jacobinic	Jacobin
jacobinical	Jacobin
jaggedly	jagged
jain	Jainism
jainist	Jainism
jamaican	Jamaica
jamesian	James
jamesian	James
japanese	Japan
jarringly	jarring
jauntily	jaunty
javan	Java
javanese	Java
jealously	jealous
jealously	jealous
jeeringly	jeering
jeffersonian	Jefferson
jejunely	jejune
jerkily	jerky
jestingly	jesting
jesuit	Jesuit
jesuit	Jesuitism
jesuitic	Jesuit
jesuitic	Jesuitism
jesuitical	Jesuit
jesuitical	Jesuitism
jet-propelled	jet propulsion
jewish	Jew
jewish-orthodox	Judaism
jihadi	jihad
jittery	jitter
jocosely	jocose
jocular	jocular
jointly	joint
jokingly	joking
jokingly	joking
jordanian	Jordan
journalistic	journalism
journalistically	journalistic
jovially	jovial
jovian	Jupiter
jovian	Jupiter
joyfully	joyful
joylessly	joyless
joyously	joyous
jubilantly	jubilant
judaic	Jew
judaic	Judaism
judaical	Judaism
judeo-christian	Christianity
judeo-christian	Judaism
judicial	judge
judicial	justice
judicially	judicial
judicially	judicial
jugular	neck
julian	Julius Caesar
jumentous	jument
jungian	Jung
jurassic	Jurassic
juridic	justice
juridic	law
juridical	justice
juridical	law
jurisprudential	jurisprudence
jurisprudentially	jurisprudential
justifiably	justifiable
justly	just
justly	just
juvenile	youth
kafkaesque	Kafka
kampuchean	Cambodia
kantian	Kant
karyokinetic	karyokinesis
kashmiri	Kashmir
katabolic	catabolism
katari	Qatar
katharobic	katharobe
kazakhstani	Kazakhstan
kechuan	Quechua
kechuan	Quechua
keenly	keen
kenyan	Kenya
keynesian	Keynes
keynesian	Keynesianism
killingly	killing
kinaesthetic	kinesthesis
kindly	kind
kinesthetic	kinesthesis
kinesthetically	kinesthetic
kinetic	kinetics
kiplingesque	Kipling
knavishly	knavish
knee-length	knee
knowingly	knowing
kokka	Kokka Shinto
koranic	Koran
korean	Korea
kurdish	Kurdistan
kuwaiti	Kuwait
kuwaiti	Kuwait
kyrgyzstani	Kyrgyzstan
labial	labium
labial	lip
laboriously	laborious
labyrinthine	labyrinth
lacertilian	lizard
lachrymal	lacrimal gland
lachrymal	tear
lachrymatory	tear
lackadaisically	lackadaisical
laconically	laconic
lacrimal	lacrimal gland
lacrimal	tear
lacrimatory	tear
lacteal	milk
lactic	milk
lactogenic	lactogen
lacustrine	lake
lamarckian	Lamarckism
lamely	lame
lancastrian	Lancaster
lancastrian	Lancaster
languidly	languid
languorously	languorous
laniary	canine
lao	Lao
laotian	Laos
lapidary	gemstone
laputan	Laputa
large-cap	market capitalization
large-capitalisation	market capitalisation
large-capitalization	market capitalization
largo	largo
larval	larva
laryngeal	larynx
laryngopharyngeal	larynx
laryngopharyngeal	pharynx
lasciviously	lascivious
lash-like	lash
last	last
lastingly	permanent
later	later
laterally	lateral
laterally	lateral
lathery	lather
lathery	lather
latin	Latin
latin	Latium
latin	Romance
latin	Romance
latin-american	Latin America
latinate	Latin
latino	Hispanic
latitudinal	latitude
latvian	Latvia
laudably	laudable
laughably	laughable
lavishly	lavish
lavishly	lavish
lawfully	lawful
lawfully	lawful
lawlessly	lawful
laxly	lax
lazily	lazy
lazily	lazy
leaden	lead
learnedly	learned
lebanese	Lebanon
legal	law
legal	law
legally	legal
legally	legal
legibly	legible
legislative	legislation
legislative	legislature
legislatively	legislative
legitimately	legitimate
legitimately	legitimate
leguminous	legume
leibnitzian	Leibnitz
leibnizian	Leibniz
leisurely	leisurely
lengthily	lengthy
leniently	lenient
lenten	Lent
leonardesque	Leonardo
leonine	lion
leprous	leprosy
lethargically	lethargic
levantine	Levant
levitical	Leviticus
lewdly	lewd
lexical	lexicon
lexical	word
lexicalised	lexicalization
lexicalized	lexicalization
lexically	lexical
lexicographic	lexicography
lexicographical	lexicography
lexicostatistic	lexicostatistics
liberally	liberal
liberally	liberal
liberian	Liberia
libidinal	libido
libyan	Libya
licentiously	licentious
licitly	licit
liechtensteiner	Liechtenstein
lienal	lien
life-support	life-support system
life-support	life-support system
lifelessly	lifeless
lifelessly	lifeless
lifelessly	lifeless
light-handedly	light-handed
lightly	light
lightly	light
lightly	light
lightly	light
lightly	light
lightsomely	lightsome
lightsomely	lightsome
liliaceous	Liliaceae
lilliputian	Lilliput
limacine	slug
limacoid	slug
limbic	limbus
limitedly	limited
limnological	limnology
limnologically	limnological
limpidly	limpid
lincolnesque	Lincoln
lincolnian	Lincoln
lineally	lineal
linearly	linear
lingual	language
lingual	tongue
lingually	lingual
linguistic	language
linguistic	linguistics
linguistically	linguistic
linguistically	linguistic
linnaean	Linnaeus
linnean	Linnaeus
listlessly	listless
literally	literal
literary	literature
lithic	lithium
lithic	stone
lithographic	lithography
lithomantic	lithomancy
lithophytic	lithophyte
lithuanian	Lithuania
litigious	litigation
littoral	littoral
liturgical	liturgy
liverpudlian	Liverpool
lividly	livid
living	living
lobar	lobe
lobate	lobe
lobated	lobe
lobeliaceous	Lobeliaceae
lobular	lobule
local	locality
locally	local
locally	local
locker-room	locker room
locomotive	locomotion
locomotor	locomotion
loftily	lofty
logarithmic	logarithm
logarithmically	logarithmic
logically	logical
logically	logical
logistic	logistics
logistical	logistics
logogrammatic	logogram
logogrammatically	logogrammatic
logographic	logograph
long-chain	long chain
long-distance	long distance
long-windedly	long-winded
longer	long
longest	long
longitudinal	longitude
longitudinally	longitudinal
longitudinally	longitudinal
loopy	loop
loosely	loose
loosely	loose
lopsidedly	lopsided
loquaciously	loquacious
loudly	loud
lovingly	loving
loweringly	lowering
loyally	loyal
lucidly	lucid
lucifugal	phototropism
lucifugous	phototropism
luckily	lucky
ludicrously	ludicrous
lugubriously	lugubrious
lukewarmly	lukewarm
lumbar	loin
lumbosacral	lumbar
lumbosacral	sacral
lunar	Moon
lung-like	lung
lunisolar	Moon
lunisolar	sun
lupine	wolf
luridly	lurid
lusciously	luscious
lusitanian	Lusitania
lustfully	lustful
lustily	lusty
luteal	corpus luteum
lutheran	Luther
lutheran	Lutheran Church
luxembourgian	Luxembourg
luxemburger	Luxemburg
luxemburger	Luxemburg
luxuriantly	luxuriant
luxuriantly	luxuriant
luxuriously	luxurious
luxuriously	luxurious
lymphatic	lymph
lymphocytic	lymphocyte
lymphoid	lymph
lyric	lyric
lyric	opera
lyrically	lyrical
lysogenic	lysis
lysogenic	lysogeny
macaronic	Latin
macaronic	vernacular
macedonian	Macedonia
macerative	maceration
machiavellian	Machiavelli
machiavellian	Machiavellianism
machine readable	machine code
macrencephalic	macrencephaly
macrencephalous	macrencephaly
macrobiotic	macrobiotics
macrocephalic	macrocephaly
macrocephalous	macrocephaly
macrocosmic	macrocosm
macroeconomic	macroeconomics
macromolecular	macromolecule
macroscopically	macroscopical
madagascan	Madagascar
madly	mad
madly	mad
magically	magical
magisterial	magistrate
magisterially	magisterial
magna cum laude	magna cum laude
magnanimously	magnanimous
magnetic	magnetism
magnetically	magnetic
magnetically	magnetic
magnificently	magnificent
magnificently	magnificent
magniloquently	magniloquent
majestically	majestic
maladroitly	maladroit
malarial	malaria
malawian	Malawi
malay	Malay
malayan	Malay
malayan	Malaya
malayo-polynesian	Malayo-Polynesian
malaysian	Malaysia
malevolently	malevolent
malian	Mali
maliciously	malicious
malignantly	malignant
malignly	malign
maltese	Malta
maltese	Malta
malthusian	Malthus
malthusian	Malthusianism
mammalian	Mammalia
mammary	mamma
manageably	manageable
managerial	management
managerially	managerial
manchurian	Manchuria
mancunian	Manchester
mandaean	Mandaean
mandaean	Mandaean
mandatorily	mandatory
mandean	Mandean
mandean	Mandean
mandibular	mandible
mandibulate	mandible
mandibulofacial	face
manfully	manful
mangily	mangy
maniacally	maniacal
manichaean	Manichaeism
manichaean	dualism
manichean	Manichaeism
manichee	Manichaeism
manifestly	manifest
manipulatively	manipulative
manorial	manor
manual	hand
manually	manual
manx	Man
maoist	Maoism
marginally	marginal
marian	Mary
marine	Marine Corps
marine	navigation
marine	sea
marital	marriage
maritime	navigation
markedly	marked
markovian	Markov process
marly	marl
marmoreal	marble
marmorean	marble
maroc	Morocco
married	marriage
marsupial	marsupium
martially	martial
martian	Mars
marvellously	marvelous
marxist	Marxism
marxist-leninist	Leninism
masochistically	masochistic
masonic	Mason
masonic	Masonry
masonic	mason
masonic	masonry
masoretic	Masorah
mass-spectrometric	mass spectrometer
mass spectroscopic	mass spectroscopy
massively	massive
masted	mast
masterfully	masterful
mastoid	mastoid
mastoid	nipple
materialistically	materialistic
materially	material
materially	material
maternal	mother
maternally	maternal
mathematical	mathematics
mathematically	mathematical
matrilineally	matrilineal
matrimonial	marriage
maturational	maturation
maturely	mature
matutinal	morning
mauritanian	Mauritius
mauritanian	Mauritius
mauritian	Mauritius
mauritian	Mauritius
mawkishly	mawkish
maxillary	maxilla
maxillodental	maxilla
maxillofacial	face
maxillomandibular	jaw
maximally	maximal
mayoral	mayor
meagerly	meager
mealy	meal
meanderingly	meandering
meaningfully	meaningful
meanly	mean
meanly	mean
meanly	mean
meanly	mean
meanspiritedly	meanspirited
measurably	measurable
measuredly	measured
mechanical	machinery
mechanical	mechanics
mechanically	mechanical
mechanically	mechanical
mechanically skillful	machinery
mechanistic	mechanism
mecopterous	mecopteran
mediaeval	Middle Ages
medially	medial
mediatorial	mediator
mediatory	mediation
mediatory	mediation
medical	medicine
medically	medical
medicinally	medicinal
medicolegal	law
medicolegal	medicine
medieval	Middle Ages
meditatively	meditative
mediterranean	Mediterranean
medullary	marrow
medullary	medulla
medullary	medulla
medullated	medulla
medusoid	medusa
meekly	meek
meekly	meek
megakaryocytic	megakaryocyte
megalithic	megalith
megaloblastic	megaloblast
meiotic	meiosis
melanesian	Melanesia
mellowly	mellow
melodic	melody
melodically	melodic
melodiously	melodious
melodramatically	melodramatic
melodramatically	melodramatic
membranous	membrane
memorably	memorable
menacingly	menacing
mendaciously	mendacious
mendelian	Mendel
menially	menial
meningeal	meninges
menopausal	menopause
mensal	dining table
menstrual	menstruation
mensural	measure
mensural	measure
mental	mentum
mental	mentum
mental	mind
mentally	mental
mentholated	menthol
mercantile	mercantilism
mercifully	merciful
mercilessly	merciless
mercurial	Mercury
mercurial	Mercury
mercurial	mercury
mercuric	mercury
mercurous	mercury
merely	mere
meretricious	prostitute
meretriciously	meretricious
meridian	noon
meridional	meridian
meritocratic	meritocracy
meritoriously	meritorious
merovingian	Merovingian
merrily	merry
mesenteric	mesentery
mesic	meson
mesoamerican	Mesoamerican
mesoblastic	mesoderm
mesodermal	mesoderm
mesolithic	Mesolithic Age
mesonic	meson
mesozoic	Mesozoic
messianic	messiah
messily	messy
metabolic	metabolism
metabolically	metabolic
metacarpal	metacarpus
metacentric	centromere
metacentric	metacenter
metallurgic	metallurgy
metallurgical	metallurgy
metamorphic	metamorphosis
metamorphous	metamorphosis
metaphorically	metaphorical
metaphysical	metaphysics
metaphysically	metaphysical
metastable	metastability
metastatic	metastasis
metatarsal	metatarsus
meteoric	meteoroid
meteoric	meteorology
meteoritic	meteorite
meteoritical	meteorite
meteorologic	meteorology
meteorological	meteorology
meteorologically	meteorologic
methodically	methodical
methodist	Methodist Church
methodological	methodology
methodologically	methodological
methylated	methyl
meticulously	meticulous
metonymically	metonymic
metric	meter
metrical	meter
metrically	metrical
metrological	metrology
metropolitan	metropolis
mexican	Mexico
micaceous	mica
michelangelesque	Michelangelo
microbial	microbe
microbic	microbe
microcephalic	microcephaly
microcephalous	microcephaly
microcosmic	microcosm
microeconomic	microeconomics
microelectronic	microelectronics
micrometeoric	micrometeorite
micrometeoritic	micrometeorite
micropylar	micropyle
microscopic	microscopy
microscopical	microscopy
microscopically	microscopic
microscopically	microscopical
microsomal	microsome
middle eastern	Middle East
migrational	migration
migrational	migration
migrational	migration
milanese	Milan
milch	milk
mildly	mild
mildly	mild
militarily	military
military	military science
millenarian	millennium
millenary	millennium
millenary	thousand
millennial	millennium
millennian	millennium
mincingly	mincing
mindfully	mindful
mindlessly	mindless
mindlessly	mindless
mineral	mineral
minimalist	minimalism
minimally	minimal
ministerial	minister
ministerial	minister
ministerially	ministerial
minoan	Minoan civilization
minty	mint
minutely	minute
miotic	miotic drug
miraculously	miraculous
mirthfully	mirthful
miserably	miserable
mishnaic	Mishna
misleadingly	misleading
missional	mission
missionary	mission
mistakenly	mistaken
mistily	misty
mistrustfully	mistrustful
mithraic	Mithraism
mithraistic	Mithraism
mitotic	mitosis
mitral	miter
mitral	mitral valve
mnemonic	mnemonics
mnemotechnic	mnemonics
mnemotechnical	mnemonics
mockingly	mocking
mockingly	mocking
modal	mode
modal	mode
moderately	moderate
moderately	moderate
modestly	modest
modishly	modish
mohammedan	Mohammed
moistly	moist
molal	mole
molar	molar
molar	mole
molar	mole
moldovan	Moldova
molecular	molecule
momentously	momentous
monacan	Monaco
monatomic	atom
monaurally	monaural
monegasque	Monaco
moneran	Monera
monetary	money
mongol	Mongolia
mongolian	Mongolia
mongolian	Mongolia
mongoloid	Mongol
mongoloid	Mongolia
mongoloid	mongolism
monistic	monism
monoatomic	atom
monocarboxylic	carboxyl
monocarpic	monocarp
monochromatic	monochromatism
monoclonal	clone
monolingually	monolingual
monometallic	metal
monomorphemic	morphemic
monophysite	Monophysitism
monophysitic	Monophysitism
monosyllabically	monosyllabic
monotonously	monotonous
monotypic	monotype
monozygotic	zygotic
monstrously	monstrous
monstrously	monstrous
monstrously	monstrous
montane	mountain
monthly	monthly
montserratian	Montserratian
monumental	monument
moodily	moody
moonily	moony
moorish	Moor
moraceous	Moraceae
moravian	Moravia
morbidly	morbid
morbilliform	morbilli
mordaciously	mordacious
moresque	Moor
mormon	Mormon Church
moroccan	Morocco
morosely	morose
morphemic	morpheme
morphologic	morphology
morphologic	morphology
morphological	morphology
morphological	morphology
morphologically	morphological
morphophonemic	morphophonemics
mortuary	death
mortuary	funeral
mosaic	Moses
moslem	Islamism
most-favored-nation	commercial treaty
mostly	most
motional	motion
motionlessly	motionless
motivational	motivation
mournfully	mournful
mousey	mouse
mousy	mouse
movingly	moving
mozambican	Mozambican
mozambican	Mozambique
mozartean	Mozart
mozartian	Mozart
muciferous	mucus
mucinoid	mucin
mucinous	mucin
mucocutaneous	mucous membrane
mucocutaneous	skin
mucoid	mucus
mucoidal	mucus
mucopurulent	mucus
mucopurulent	pus
mucosal	mucosa
mucose	mucus
mucous	mucus
mud-brick	mud brick
muhammadan	Muhammad
mulishly	mulish
multicultural	multiculturalism
multifariously	multifarious
multilaterally	multilateral
multilevel	floor
multinomial	multinomial
multinucleate	nucleus
multiphase	phase
multiplicatively	multiplicative
multiply	multiple
mundanely	mundane
mundanely	mundane
municipal	municipality
municipally	municipal
munificently	munificent
mural	wall
murderously	murderous
murderously	murderous
murine	family Muridae
murkily	murky
muscovite	Muscovite
muscular	muscle
musculoskeletal	muscle
musculoskeletal	skeleton
musical	music
musically	musical
musicological	musicology
musicologically	musicological
musingly	musing
muslim	Islamism
mutafacient	mutagen
mutagenic	mutagen
mutant	mutation
mutational	mutation
mutative	mutation
mutely	mute
mutually	mutual
muzzle-loading	gun muzzle
myalgic	myalgia
mycenaean	Mycenae
myelic	spinal cord
myelinated	myelin
myelinic	myelin
myeloid	bone marrow
myeloid	spinal cord
myocardial	myocardium
myoid	muscle
myopathic	myopathy
myotic	myotic drug
myotonic	myotonia
myrmecophytic	myrmecophyte
mysteriously	mysterious
mystic	mysticism
mystic	mysticism
mystical	mysticism
mystical	mysticism
mystically	mystical
mythic	myth
nacreous	nacre
naively	naive
nakedly	naked
nakedly	naked
namibian	Namibia
nanocephalic	nanocephaly
napoleonic	Napoleon
narcoleptic	narcolepsy
narcotic	narcotic
narial	naris
narrow-mindedly	narrow-minded
narrowly	narrow
nasal	nose
nasally	nasal
nasopharyngeal	nasopharynx
nastily	nasty
natal	birth
natal	nates
national	nation
national	nation
national	nationality
national socialist	socialism
nationally	national
nationally	national
native american	American Indian
nativist	nativism
nativist	nativism
nativistic	nativism
nativistic	nativism
natriuretic	natriuresis
nattily	natty
naturally	natural
naturistic	naturism
naughtily	naughty
nauruan	Nauru
nautical	navigation
naval	navy
navigational	navigation
nazarene	Nazarene
nazarene	Nazarene
nazarene	Nazareth
nazi	Nazism
nazi	socialism
neandertal	Neanderthal man
neanderthal	Neanderthal man
neanderthalian	Neanderthal man
neapolitan	Naples
neatly	neat
nebular	nebula
nebulous	nebula
nebulously	nebulous
necessarily	necessary
necessarily	necessary
neck and neck	neck and neck
necromantic	necromancy
necromantical	necromancy
necrotic	necrosis
nectar-rich	nectar
nectariferous	nectary
needfully	needful
needlessly	needless
nefariously	nefarious
negatively	negative
negatively	negative
neglectfully	neglectful
negligently	negligent
neo-darwinian	neo-Darwinism
neo-lamarckian	Neo-Lamarckism
neoclassicist	neoclassicism
neoclassicistic	neoclassicism
neocortical	neocortex
neolithic	Neolithic Age
neonatal	neonate
neoplastic	neoplasm
neotenic	neoteny
neotenous	neoteny
nepalese	Nepal
nepali	Nepal
nephritic	kidney
nephritic	nephritis
neritic	neritic zone
nervelessly	nerveless
nervily	nervy
nervous	nervous system
nervously	nervous
nervously	nervous
nestorian	Nestorianism
nestorian	Nestorius
neural	nervous system
neural	neuron
neuralgic	neuralgia
neurasthenic	neurasthenia
neuroanatomic	neuroanatomy
neuroanatomical	neuroanatomy
neurobiological	neurobiological
neurobiological	neurobiology
neuroendocrine	endocrine system
neuroendocrine	nervous system
neurogenic	nervous tissue
neuroglial	neuroglia
neurologic	neurology
neurological	neurology
neuromatous	neuroma
neuromuscular	muscle
neuromuscular	nerve
neuronal	neuron
neuronic	neuron
neurophysiological	neurophysiology
neuropsychiatric	neuropsychiatry
neuropsychological	neuropsychology
neurotic	neurosis
neurotically	neurotic
neurotoxic	neurotoxin
neurotropic	neurotropism
new caledonian	New Caledonia
new zealander	New Zealand
newtonian	Newton
nicaean	Nicaea
nicaraguan	Nicaragua
nicely	nice
nicene	Nicaea
nigerian	Nigeria
nigerian	Nigerian
nigerien	Nigerian
nihilistic	nihilism
nilotic	Nile
nilotic	Nilotic
nilpotent	zero
nimbly	nimble
nip and tuck	nip and tuck
nitric	nitrogen
nitrogen-fixing	nitrogen fixation
nitrogenous	nitrogen
nitrous	nitrogen
noachian	Noah
nobly	noble
nocturnal	night
nocturnally	nocturnal
nodular	nodule
noiselessly	noiseless
noisily	noisy
nominal	name
nominal	noun
nominalistic	nominalism
nominally	nominal
nominative	nominative
non-metric	meter
noncaloric	nutritionist's calorie
nonchalantly	nonchalant
nonchalantly	nonchalant
noncompetitively	noncompetitive
noncomprehensively	noncomprehensive
nonenzymatic	enzyme
nonfictional	nonfiction
nonfinancial	finance
nonharmonic	harmony
nonionic	ion
nonlexical	word
nonlexically	nonlexical
nonlinguistic	language
nonparametric	nonparametric statistic
nonpasserine	passerine
nonphotosynthetic	photosynthesis
nonruminant	Ruminantia
nonspatial	space
nonspecifically	nonspecific
nonspherical	sphere
nonsteroidal	nonsteroid
nonsuppurative	suppuration
nonsurgical	surgery
nonthermal	heat
nontranslational	translation
nonverbally	nonverbal
nonviolently	nonviolent
nordic	Scandinavian
nordic	northern Europe
norman	Norman
norman	Normandy
normative	norm
norse	Norway
north african	North Africa
north american	North America
north korean	North Korea
north vietnamese	North Vietnam
northeastward	northeastward
northeastwardly	northeastward
northerly	northerly
northwestward	northwestward
northwestwardly	northwestward
norwegian	Norway
nosocomial	hospital
noticeably	noticeable
noxiously	noxious
nuclear	nucleus
nuclear	nucleus
nucleate	nucleus
nucleated	nucleus
numbly	numb
numeral	number
numeric	number
numerical	number
numerically	numerical
numerological	numerology
numidian	Numidia
numinous	numen
nuptial	wedding
nutritional	nutrition
nutritionally	nutritional
nutritionary	nutrition
nuttily	nutty
oaten	oat
obdurately	obdurate
obediently	obedient
objectionably	objectionable
objective	objective case
objectively	objective
obligational	obligation
obligatorily	obligatory
obligatorily	obligatory
obligingly	obliging
obliquely	oblique
obnoxiously	obnoxious
obscenely	obscene
obscurely	obscure
obsequiously	obsequious
observably	observable
observantly	observant
observingly	observing
obsessionally	obsessional
obsessively	obsessive
obstetric	obstetrics
obstetrical	obstetrics
obstinately	obstinate
obstreperously	obstreperous
obstructively	obstructive
obtrusively	obtrusive
obtusely	obtuse
obviously	obvious
occasionally	occasional
occipital	occiput
occlusive	occlusion
occupational	occupation
oceanic	ocean
ocellated	ocellus
octagonal	octagon
octal	octal numeration system
octangular	octagon
ocular	eye
ocular	sight
oddly	odd
oddly	odd
odiously	odious
offensively	offensive
offensively	offensive
offensively	offensive
offhandedly	offhanded
offhandedly	offhanded
official	office
officially	official
officially	official
officiously	officious
ohmic	ohm
oleaceous	Oleaceae
olfactive	smell
olfactory	smell
oligarchic	oligarchy
oligarchical	oligarchy
olympian	Mount Olympus
olympian	Olympia
olympic	Olympia
olympic	Olympic Games
omani	Oman
ominously	ominous
omissive	omission
omnidirectional	direction
on-the-job	job
oncologic	oncology
oncological	oncology
one-humped	hump
oneiric	dream
onerously	onerous
onomastic	onomastics
onomatopoeic	onomatopoeia
onomatopoetic	onomatopoeia
ontogenetic	ontogeny
ontological	ontology
opaquely	opaque
open-hearth	open-hearth furnace
open-source	source code
openly	open
operatic	opera
operational	operation
operationalist	operationalism
operationally	operational
operatively	operative
operculate	operculum
operculated	operculum
ophthalmic	eye
ophthalmic	ophthalmology
opportunely	opportune
oppositely	opposite
oppressively	oppressive
optative	optative mood
optative	option
opthalmic	eye
optic	eye
optic	sight
optical	eye
optical	optics
optical	sight
optically	optical
optimally	optimal
optimistically	optimistic
optionally	optional
opulently	opulent
oracular	oracle
orad	oral
oral	mouth
orally	oral
orally	oral
orb-weaving	orb-weaver
orbital	orbit
orbital	orbit
orchestral	orchestra
orchestrated	orchestra
ordinal	order
ordinarily	ordinary
organically	organic
organically	organic
organically	organic
organicistic	organicism
organisational	organisation
organismal	organism
organismic	organism
organizational	organization
organizationally	organizational
originally	original
ornamentally	ornamental
ornithological	ornithology
oropharyngeal	oropharynx
orphic	Orpheus
orthodontic	orthodontics
orthodox	Judaism
orthodox	Orthodox Church
orthographic	orthography
orthopaedic	orthopedics
orthopedic	orthopedics
orthopedical	orthopedics
orthoptic	binocular vision
orwellian	Orwell
oscine	oscine bird
osmotic	osmosis
osmotically	osmotic
osseous	bone
ossicular	ossicle
ossiculate	ossicle
ossiferous	bone
osteal	bone
osteal	bone
ostensibly	ostensible
ostentatiously	ostentatious
otic	ear
ottoman	Ottoman Empire
outdoor	outdoors
outlandishly	outlandish
outrageously	outrageous
outrageously	outrageous
outspokenly	outspoken
outstandingly	outstanding
outwardly	outward
ovarian	ovary
overbearingly	overbearing
overpoweringly	overpowering
overtly	overt
overwhelmingly	overwhelming
ovine	sheep
ovular	ovule
ovular	ovum
owlishly	owlish
oxonian	Oxford
oxonian	Oxford
pachydermal	pachyderm
pachydermatous	pachyderm
pachydermic	pachyderm
pachydermous	pachyderm
pacific	Pacific
pacifically	pacific
pacifistically	pacifistic
packable	pack
paediatric	paediatrics
painfully	painful
painfully	painful
painlessly	painless
painstakingly	painstaking
pakistani	Pakistan
palaeolithic	Stone Age
palaeontological	palaeontology
palatably	palatable
palatal	palate
palatial	palace
palatine	palace
palatine	palate
palatine	palatine
palatoglossal	glossa
palatoglossal	palate
palely	pale
palely	pale
paleoanthropological	paleoanthropology
paleocortical	paleocortex
paleolithic	Paleolithic Age
paleontological	paleontology
paleozoic	Paleozoic
palestinian	Palestine
palingenetic	palingenesis
palladian	Palladio
pallidly	pallid
palmar	palm
palmar	sole
palmately	palmate
palpably	palpable
palpatory	palpation
palpebrate	palpebra
pan-hellenic	Hellenism
panamanian	Panama
pancreatic	pancreas
panhellenic	Hellenism
panicled	panicle
paniculate	panicle
pantheist	pantheism
pantheistic	pantheism
papal	pope
paperlike	paper
papery	paper
papillary	papilla
papillate	papilla
papilliform	papilla
papillose	papilla
papuan	Papua
parabolic	parable
parabolical	parable
paradigmatic	paradigm
paradigmatic	paradigm
paradigmatic	paradigm
paradoxically	paradoxical
paraguayan	Paraguay
paralytic	paralysis
paralytical	paralysis
paramagnetic	paramagnet
parametric	parameter
paramilitary	paramilitary
paranasal	nasal cavity
parasitic	epenthesis
parasitic	parasite
parasitical	parasite
parasitically	parasitic
parasympathetic	parasympathetic nervous system
parasympathomimetic	parasympathetic nervous system
pardonably	pardonable
parental	parent
parentally	parental
parenteral	alimentary canal
parenteral	parenteral
parenterally	parenteral
parenthetically	parenthetical
parheliacal	parhelion
parhelic	parhelion
parietal	parietal bone
parisian	Paris
parliamentary	parliament
parochial	parish
parochially	parochial
parotid	parotid gland
parous	parity
paroxysmal	paroxysm
parthian	Parthia
partially	partial
participial	participle
particularistic	particularism
particularly	particular
particularly	particular
particularly	particular
partitive	part
partitive	partition
parturient	parturition
paschal	Pasch
passerine	passerine
passionately	passionate
passively	passive
pasteurian	Pasteur
pastoral	pastor
pastoral	shepherd
patchily	patchy
patellar	patella
patently	patent
paternal	father
paternally	paternal
pathetically	pathetic
pathetically	pathetic
pathogenically	pathogenic
pathologic	pathology
pathological	pathology
pathologically	pathological
patiently	patient
patriarchal	patriarch
patrilineally	patrilineal
patriotically	patriotic
patristic	Church Father
patristical	Church Father
patronisingly	patronising
patronizingly	patronizing
patronymic	patronymic
pauline	Paul
pavlovian	Pavlov
peaceably	peaceable
peacefully	peaceful
peacekeeping	peacekeeping
peaty	peat
pectic	pectin
pectineal	pubis
pectoral	chest
peculiarly	peculiar
peculiarly	peculiar
peculiarly	peculiar
pecuniary	money
pedagogic	pedagogy
pedagogical	pedagogy
pedagogically	pedagogic
pedal	vertebrate foot
pedantically	pedantic
pediatric	pediatrics
peevishly	peevish
pejoratively	pejorative
pelagic	sea
pellucidly	pellucid
peloponnesian	Peloponnesus
pelvic	pelvis
pemphigous	pemphigus
penal	punishment
penally	penal
penetratingly	penetrating
penetratively	penetrative
penial	penis
penicillin-resistant	penicillin
penile	penis
peninsular	peninsula
penitentially	penitential
penitently	penitent
pensively	pensive
pentagonal	pentagon
pentangular	pentagon
pentatonic	pentatonic scale
pentavalent	valence
pentecostal	Pentecost
pentecostal	Pentecostal religion
penumbral	penumbra
penuriously	penurious
peptic	digestion
perceptibly	perceptible
perceptive	perception
perceptively	perceptive
perceptual	perception
perceptually	perceptual
percussive	percussion
percutaneous	skin
peremptorily	peremptory
perennially	perennial
perfectly	perfect
perfectly	perfect
perfidiously	perfidious
perfunctorily	perfunctory
perianal	anus
pericardiac	pericardium
pericardial	pericardium
perigonal	perigone
perilously	perilous
perinasal	nose
perineal	perineum
periodically	periodical
periodontal	periodontics
periodontic	periodontics
peripatetic	Aristotle
peripherally	peripheral
peripherally	peripheral
perirhinal	nose
perithelial	perithelium
peritoneal	peritoneum
perkily	perky
permanently	permanent
permissibly	permissible
permissively	permissive
perniciously	pernicious
perniciously	pernicious
peroneal	fibula
perpendicularly	perpendicular
perpetually	perpetual
perpetually	perpetual
perplexedly	perplexed
perseveringly	persevering
persistently	persistent
persistently	persistent
personal	person
personal	personality
personally	personal
personally	personal
personally	personal
perspicuously	perspicuous
persuasively	persuasive
pertinaciously	pertinacious
pertinently	pertinent
pertly	pert
peruvian	Peru
pervasively	pervasive
perversely	perverse
perversely	perverse
pessimistically	pessimistic
petaloid	petal
pettily	petty
pettishly	pettish
petulantly	petulant
phagocytic	phagocyte
phalangeal	phalanx
phallic	phallus
pharaonic	Pharaoh
pharmaceutic	pharmaceutics
pharmaceutic	pharmacist
pharmaceutical	pharmaceutical
pharmaceutical	pharmaceutics
pharmaceutical	pharmacist
pharmacologic	pharmacology
pharmacological	pharmacology
pharmacologically	pharmacological
pharyngeal	pharynx
phenomenal	phenomenon
phenomenally	phenomenal
phenotypic	phenotype
phenotypical	phenotype
philanthropic	philanthropy
philanthropically	philanthropic
philatelic	philately
philatelical	philately
philatelically	philatelic
philharmonic	orchestra
philhellene	philhellene
philhellenic	philhellene
philippine	Philippines
philistine	Philistia
philistine	Philistine
philological	philology
philosophic	philosophy
philosophical	philosophy
philosophically	philosophical
philosophically	philosophical
phlegmatically	phlegmatic
phocine	seal
phoenician	Phoenicia
phonemic	phoneme
phonemic	phonemic
phonetic	phone
phonetic	phonetics
phonetically	phonetic
phonic	phone
phonic	phonics
phonic	speech
phonogramic	phonogram
phonologic	phonology
phonological	phonology
phosphoric	phosphorus
phosphorous	phosphorus
photic	light
photochemical	photochemistry
photoconductive	photoconductivity
photoelectric	electricity
photoelectrical	photoelectricity
photoelectrically	photoelectric
photoemissive	photoemission
photographic	photography
photographically	photographic
photomechanical	photomechanics
photometric	photometry
photometrical	photometry
photometrically	photometric
photosynthetic	photosynthesis
photovoltaic	voltage
phrasal	phrase
phreatic	ground water
phrenic	diaphragm
phrenological	phrenology
phyletic	phylogeny
phyllodial	phyllode
phylogenetic	phylogeny
phylogenetically	phylogenetic
physical	physics
physically	physical
physicochemical	physical chemistry
physiological	physiology
physiologically	physiological
physiotherapeutic	physiotherapy
piagetian	Piaget
pianissimo	pianissimo
pianistic	pianist
pianistic	piano
piano	piano
pictographic	pictograph
pictorial	picture
pictorially	pictorial
pictural	picture
picturesquely	picturesque
piercingly	piercing
pietistic	Pietism
pietistical	Pietism
piezoelectric	piezoelectricity
pig-headedly	pigheaded
piggishly	piggish
pilar	pilus
pilosebaceous	hair follicle
pilosebaceous	sebaceous gland
pineal	pineal body
pinnately	pinnate
piously	pious
piquantly	piquant
piratical	piracy
piratical	pirate
piratically	piratical
piscatorial	fishing
piscatory	fishing
piscine	fish
piteously	piteous
pithily	pithy
pitiably	pitiable
pitifully	pitiful
pitilessly	pitiless
pituitary	pituitary
placatingly	placating
placidly	placid
placidly	placid
plagioclastic	plagioclase
plaguily	plaguy
plainly	plain
plaintively	plaintive
plane-polarized	polarization
planetal	planet
planetary	Earth
planetary	planet
planktonic	plankton
planographic	planography
plantal	plant
plantar	sole
plastically	plastic
platonic	Plato
platonistic	Platonism
plausibly	plausible
playfully	playful
pleasantly	pleasant
pleasantly	pleasant
pleasingly	pleasing
pleasurably	pleasurable
plenarily	plenary
plenteously	plenteous
plentifully	plentiful
pleochroic	pleochroism
pleomorphic	pleomorphism
pleural	pleura
ploddingly	plodding
pluckily	plucky
plumbaginaceous	Plumbaginaceae
plumbic	lead
plumbous	lead
pluralistic	pluralism
plutocratic	plutocrat
plutocratical	plutocrat
pneumatic	air
pneumatically	pneumatic
pneumococcal	pneumococcus
pneumogastric	lung
pneumogastric	pneumogastric
pneumogastric	stomach
pneumonic	lung
pneumonic	pneumonia
poetic	poet
poetic	poetry
poetical	poetry
poetically	poetic
poignantly	poignant
point-of-sale	point
pointedly	pointed
pointlessly	pointless
poisonously	poisonous
polar	pole
polarographic	polarography
polemically	polemic
polemoniaceous	family Polemoniaceae
polish	Poland
politely	polite
political	politics
political	politics
politically	political
politically	political
politically correct	political correctness
politically incorrect	political incorrectness
polyatomic	atom
polydactyl	dactyl
polydactylous	dactyl
polygonal	polygon
polygonally	polygonal
polyhedral	polyhedron
polymeric	polymer
polymorphemic	morphemic
polymorphic	polymorphism
polymorphic	polymorphism
polymorphous	polymorphism
polymorphous	polymorphism
polynesian	Polynesia
polynomial	polynomial
polyphase	phase
polyphonic	polyphone
polyphonic	polyphony
polyphonically	polyphonic
polyphonous	polyphony
polysyllabically	polysyllabic
pompous	pomp
pompously	pompous
ponderously	ponderous
ponderously	ponderous
pontifical	bishop
pontifical	pope
poorly	poor
popishly	popish
popliteal	knee
popularly	popular
porcine	swine
pornographically	pornographic
porphyritic	porphyry
portentously	portentous
portuguese	Portugal
positionable	position
positional	position
positive	positivism
positively	positive
positively	positive
positivist	positivism
positivistic	positivism
possessive	possessive case
possessively	possessive
possibly	possible
post-communist	communism
postal	post
postbiblical	Bible
postdiluvian	Noachian deluge
postdoctoral	postdoc
postexilic	Babylonian Captivity
postganglionic	ganglion
postglacial	glacial period
posthumously	posthumous
postictal	ictus
postmenopausal	menopause
postmillennial	millennium
postmodern	postmodernism
postmodernist	postmodernism
postnuptial	wedding
postoperatively	postoperative
postpositive	postposition
postural	posture
potentially	potential
potently	potent
pouched	pouch
powerfully	powerful
powerfully	powerful
powerlessly	powerless
practicably	practicable
practically	practical
praetorial	praetor
praetorian	praetor
pragmatic	pragmatism
pragmatical	pragmatism
pragmatically	pragmatic
praiseworthily	praiseworthy
prakritic	Prakrit
prandial	meal
pre-christian	Christian era
pre-columbian	Columbian
pre-jurassic	Jurassic
pre-raphaelite	Pre-Raphaelite
pre-socratic	Socrates
preanal	anus
precancerous	cancer
precariously	precarious
precedentedly	precedented
precipitately	precipitate
precipitously	precipitous
precisely	exact
precisely	precise
preclinical	medical diagnosis
precociously	precocious
precordial	precordium
predestinarian	predestination
predicatively	predicative
predictably	predictable
predominantly	predominant
preeminently	preeminent
prefectural	prefecture
preferentially	preferential
prehistoric	prehistory
prejudicial	prejudice
prejudicious	prejudice
prelapsarian	fall
premarital	wedding
prematurely	premature
prematurely	premature
premedical	medicine
premenopausal	menopause
premenstrual	menstruation
prenuptial	wedding
preponderantly	preponderant
prepositional	preposition
prepositionally	prepositional
presciently	prescient
presentably	presentable
presentational	presentation
presently	present
presidential	president
presidentially	presidential
presocratic	Socrates
pressingly	pressing
pressor	blood pressure
presumably	presumable
presumptuously	presumptuous
presymptomatic	medical diagnosis
pretentiously	pretentious
preternaturally	preternatural
pretorial	praetor
pretorian	praetor
prettily	pretty
previously	previous
priestly	priesthood
priggishly	priggish
primarily	primary
primarily	primary
prime	prime number
primiparous	primipara
primitively	primitive
primly	prim
principally	principal
prismatic	prism
prissily	prissy
privately	private
pro-american	America
probabilistic	probabilism
probabilistic	probability
probabilistically	probabilistic
probably	probable
probably	probable
problematically	problematic
procaryotic	prokaryote
procedural	procedure
processional	procession
processional	procession
proconsular	proconsul
procrustean	Procrustes
prodigally	prodigal
prodigiously	prodigious
prodromal	prodrome
prodromic	prodrome
productively	productive
profanely	profane
profanely	profane
professedly	professed
professedly	professed
professional	profession
professional	profession
professionally	professional
professorial	professor
professorially	professorial
proficient	proficiency
proficiently	proficient
profitlessly	profitless
profligately	profligate
profoundly	profound
progestational	gestation
progestational	progesterone
progressively	progressive
prohibitively	prohibitive
prokaryotic	prokaryote
prolusory	prolusion
prominently	prominent
promiscuously	promiscuous
promiscuously	promiscuous
promisingly	promising
promissory	promise
promotional	promotion
promotional	promotion
promptly	prompt
promptly	prompt
pronominal	pronoun
propagandist	propagandist
propagandistic	propagandist
propagative	propagation
properly	proper
prophetically	prophetic
propitiously	propitious
proportionally	proportional
proportionately	proportionate
proportionately	proportionate
proportionately	proportionate
proprioceptive	proprioception
propulsive	propulsion
prosaically	prosaic
prosily	prosy
prosodic	prosody
prosperously	prosperous
prostate	prostate gland
prostatic	prostate gland
prosthetic	prosthesis
prosthetic	prosthetics
prosthodontic	prosthodontics
protectively	protective
proteinaceous	protein
proteolytic	proteolysis
protestant	Protestant
protestant	Protestantism
protozoal	phylum Protozoa
protozoan	phylum Protozoa
protozoic	phylum Protozoa
protozoological	zoological
protractedly	protracted
proudly	proud
proustian	Proust
provably	provable
provencal	Provence
proverbial	proverb
proverbially	proverbial
providential	providence
providentially	providential
providentially	providential
providently	provident
provincial	province
provincially	provincial
provisionally	provisional
provocatively	provocative
provokingly	provoking
prudently	prudent
prudishly	prudish
pruriently	prurient
prussian	Prussia
pryingly	prying
psychiatric	psychiatry
psychiatrical	psychiatry
psychically	psychic
psychoanalytic	psychoanalysis
psychoanalytical	psychoanalysis
psychogenetic	psychogenesis
psychogenetic	psychogenesis
psychogenic	psychogenesis
psycholinguistic	psycholinguistics
psychological	psychology
psychologically	psychological
psychologically	psychological
psychometric	psychometry
psychomotor	idea
psychomotor	reaction
psychopharmacological	psychopharmacology
psychosexual	psychosexuality
psychotherapeutic	psychotherapy
pteridological	pteridology
ptolemaic	Ptolemy
pubertal	puberty
pubic	pubis
publicly	public
publicly	public
puckishly	puckish
pudendal	pudendum
puerile	child
puerperal	childbirth
puerperal	puerpera
puerperal	puerperium
pugilistic	pugilism
pugilistic	pugilist
pugnaciously	pugnacious
pulmonary	lung
pulmonic	lung
punctiliously	punctilious
punctually	punctual
pungently	pungent
pungently	pungent
punily	puny
punishingly	punishing
punitively	punitive
punitorily	punitory
pupillary	pupil
puranic	Purana
purgatorial	purgation
purgatorial	purgatory
purging	purgation
purifying	purgation
puritanical	Puritanism
puritanical	puritan
puritanically	puritanical
purposefully	purposeful
purposelessly	purposeless
pusillanimously	pusillanimous
putrid	putrefaction
pyaemic	pyaemia
pycnotic	pyknosis
pyemic	pyemia
pyknotic	pyknosis
pyloric	pylorus
pyogenic	pyorrhea
pyramidically	pyramidical
pyrectic	pyrogen
pyrochemical	chemical
pyroelectric	pyroelectricity
pyroelectrical	pyroelectricity
pyrogallic	pyrogallol
pyrogenetic	pyrogen
pyrogenic	heat
pyrogenic	pyrogen
pyrogenous	heat
pyrogenous	pyrogen
pyrographic	pyrography
pyroligneous	pyrolysis
pyrolignic	pyrolysis
pyrolytic	pyrolysis
pyrotechnic	pyrotechnics
pyrotechnical	pyrotechnics
pyrrhic	Pyrrhus
pyrrhic	pyrrhic
pyrrhic	pyrrhic
pythagorean	Pythagoras
qatari	Qatar
quadrangular	quadrangle
quadraphonic	quadraphony
quadrasonic	quadraphony
quadratic	square
quadratic	square
quadriphonic	quadraphony
quadrisonic	quadraphony
quaintly	quaint
quaintly	quaint
qualitative	qualitative analysis
qualitatively	qualitative
quantal	quantum
quantitative	quantity
quantitatively	quantitative
quantized	quantum
quartan	time period
quarterly	quarter
quarterly	quarterly
quartzose	quartz
quaveringly	quavering
queasily	queasy
quebecois	Quebec
quechuan	Quechua
quechuan	Quechua
queerly	queer
querulously	querulous
questionably	questionable
questioningly	questioning
questioningly	questioning
quicker	quick
quickest	quick
quickly	quick
quickly	quick
quickly	quick
quietly	quiet
quietly	quiet
quincentenary	quincentenary
quincentennial	quincentennial
quintessential	quintessence
quixotically	quixotic
quizzically	quizzical
r.c.	Romanism
rabbinic	rabbi
rabbinical	rabbi
rabelaisian	Rabelais
rabid	rabies
racial	race
racially	racial
racily	racy
radial	radius
radial	radius
radial	ray
radial-ply	pneumatic tire
radially	radial
radiantly	radiant
radical	root
radically	radical
radio	radiant energy
radioactively	radioactive
radiographic	radiography
radiological	radiology
radiophonic	radiotelephony
radiotelephonic	radiotelephony
raffishly	raffish
raggedly	ragged
rakishly	rakish
rampantly	rampant
randomly	random
rapaciously	rapacious
rapidly	rapid
raptorial	raptor
rapturously	rapturous
rarely	rare
rashly	rash
raspingly	rasping
rastafarian	Rastafarianism
rational	ratio
rationalist	rationalism
rationalistic	rationalism
rationally	rational
ratlike	rat
ratty	rat
raucously	raucous
raucously	raucous
ravenously	ravenous
ravishingly	ravishing
rayless	ray
readably	readable
real-time	real time
realistic	realism
realistically	realistic
realistically	realistic
really	real
really	real
reasonably	reasonable
reasonably	reasonable
reassuringly	reassuring
rebelliously	rebellious
recently	recent
receptively	receptive
recessional	recession
recessionary	recession
recessive	recession
reciprocally	reciprocal
reciprocally	reciprocal
reciprocally	reciprocal
recklessly	reckless
recognizably	recognizable
recoilless	recoil
recombinant	recombinant DNA
recreational	recreation
rectal	rectum
rectosigmoid	rectum
rectosigmoid	sigmoid colon
recurrently	recurrent
redemptional	redemption
redemptive	redemption
redemptory	redemption
redly	red
reductionist	reductionism
reflectively	reflective
reflexly	reflex
refractile	refraction
refractive	refraction
refractory-lined	refractory
refreshingly	refreshing
refreshingly	refreshing
regally	regal
regimental	regiment
regimentally	regimental
regional	region
regionally	regional
regretfully	regretful
regrettably	regrettable
regularly	even
regularly	regular
regularly	regular
relatively	relative
relativistic	relativism
relativistic	relativity
relativistically	relativistic
relentlessly	relentless
relevantly	relevant
reliably	reliable
religiously	religious
religiously	religious
reluctantly	reluctant
remarkably	remarkable
rembrandtesque	Rembrandt
reminiscently	reminiscent
remorsefully	remorseful
remorselessly	remorseless
remotely	remote
renal	kidney
rental	rent
rental	rental
repeatedly	repeated
repellently	repellent
repellingly	repelling
repentantly	repentant
repetitively	repetitive
reportedly	reported
reprehensibly	reprehensible
reprehensively	reprehensible
reproachfully	reproachful
reproducibly	reproducible
reprovingly	reproving
reptilian	Reptilia
republican	Republican Party
repulsively	repulsive
reputably	reputable
resentfully	resentful
reservedly	reserved
residential	residence
residentially	residential
residual	residue
residuary	residue
residuary	residuum
resinated	resin
resinlike	resin
resistive	resistance
resolutely	resolute
resoundingly	resounding
resourcefully	resourceful
respectably	respectable
respectably	respectable
respectfully	respectful
respectively	respective
respiratory	respiration
resplendently	resplendent
responsibly	responsible
responsive	response
restfully	restful
restively	restive
restlessly	restless
restrictively	restrictive
retentive	retention
retentively	retentive
reticently	reticent
retinal	retina
retroactively	retroactive
retrospectively	retrospective
revenant	revenant
revengefully	revengeful
reverentially	reverential
reverently	reverent
reversibly	reversible
reversionary	reversion
revivalistic	revivalism
revoltingly	revolting
revolutionary	revolution
revolutionary	revolution
rewardingly	rewarding
rhapsodically	rhapsodic
rhenish	Rhine
rheologic	rheology
rheological	rheology
rhetorical	rhetoric
rhetorically	rhetorical
rhinal	nose
rhizoidal	rhizoid
rhizomatous	rhizome
rhodesian	Rhodesia
rhombic	rhombus
rhomboid	rhomboid
rhomboidal	rhomboid
rhythmically	rhythmical
richly	rich
richly	rich
rickettsial	rickettsia
ridiculously	ridiculous
riemannian	Riemann
right	right
righteously	righteous
rightfully	rightful
rightly	right
rigidly	rigid
rigorously	rigorous
riotously	riotous
riotously	riotous
riparian	riverbank
ripely	ripe
riskily	risky
ritual	religious rite
ritual	rite
ritualistic	ritualism
ritually	ceremonial
robotic	robot
robustly	robust
rocket-propelled	rocket propulsion
roentgenographic	roentgenography
roguishly	roguish
roguishly	roguish
rollickingly	rollicking
romaic	Greece
roman	Roman
roman	Romanism
roman	Rome
roman	roman
roman catholic	Romanism
romance	Romance
romani	Gypsy
romanian	Romania
romanist	Romanism
romansh	Romansh
romantic	Romanticism
romantically	romantic
romantically	romantic
romanticist	Romanticism
romanticistic	Romanticism
romany	Gypsy
romish	Romanism
roomily	roomy
rooseveltian	Roosevelt
ropey	rope
ropy	rope
rosaceous	Rosaceae
rosicrucian	Rosicrucian
rotary	rotation
rotational	rotation
rotationally	rotational
rotatory	rotation
rottenly	rotten
rotundly	rotund
roughly	rough
roughly	rough
roumanian	Romania
roundly	round
rousseauan	Rousseau
rowdily	rowdy
royal	monarch
royal	royalty
royally	royal
ruandan	Rwanda
rudely	rude
ruefully	rueful
ruggedly	rugged
ruinously	ruinous
rumanian	Romania
rumansh	Rumansh
ruminant	Ruminantia
runic	rune
rupestral	rock
rupicolous	rock
rural	country
rurally	rural
ruritanian	Ruritania
russian	Russia
russian orthodox	Orthodox Church
ruthlessly	ruthless
rwandan	Rwanda
sabahan	Sabah
sabbatarian	Sabbath
sabbatic	Sabbath
sabbatical	Sabbath
sabbatical	sabbatical leave
sabine	Sabine
saccadic	saccade
sacculate	saccule
sacculated	saccule
sacerdotal	priesthood
sacerdotal	sacerdotalism
sacral	sacrum
sacramental	sacrament
sacredly	sacred
sacrificial	sacrifice
sacrilegiously	sacrilegious
sadducean	Sadducee
sadly	sad
sadly	sad
sadly	sad
sadomasochistic	sadomasochism
sagaciously	sagacious
sagely	sage
saharan	Sahara
salaciously	salacious
salamandriform	salamander
salientian	Salientia
salivary	saliva
salvadoran	El Salvador
salvadorean	El Salvador
salvific	salvation
samoan	Samoa
san marinese	San Marino
sanctimoniously	sanctimonious
sanely	sane
sanely	sane
sanious	sanies
sapiens	Homo sapiens
sapiently	sapient
saponaceous	soap
sapphirine	sapphire
saprobic	saprobe
saprophytic	saprophyte
sarawakian	Sarawak
sarcastically	sarcastic
sarcolemmal	sarcolemma
sarcolemmic	sarcolemma
sarcolemnous	sarcolemma
sarcosomal	sarcosome
sardinian	Sardinia
sardonically	sardonic
sartorial	sartorius
sartorial	tailor
sartorial	tailoring
satanic	Satan
satirically	satirical
satisfactorily	satisfactory
satyric	satyr
satyrical	satyr
saucily	saucy
saudi	Saudi Arabia
saudi-arabian	Saudi Arabia
saurian	lizard
savagely	savage
savagely	savage
saxatile	saxicolous plant
saxicoline	saxicolous plant
saxicolous	saxicolous plant
saxon	Saxon
scalar	scale
scalar	scale
scalene	scalene muscle
scalene	scalene triangle
scalic	scale
scandalously	scandalous
scandinavian	Scandinavia
scantily	scanty
scapular	scapula
scapulohumeral	humerus
scapulohumeral	scapula
scarcely	scarce
scarily	scary
scathingly	scathing
scenic	scenery
scenically	scenic
sceptically	sceptical
schematically	schematic
schismatic	schism
schismatical	schism
schismatically	schismatic
schizoid	schizophrenia
schizophrenic	schizophrenia
scholastic	Scholasticism
scholastic	school
scholastically	scholastic
sciatic	hip
sciatic	sciatica
scienter	deliberate
scientific	scientific knowledge
scientifically	scientific
sclerosed	sclerosis
sclerotic	sclera
sclerotic	sclerosis
scopal	scope
scorbutic	scurvy
scorching	scorching
scornfully	scornful
scotch	Scotland
scotomatous	scotoma
scots	Scotland
scottish	Scotland
scrappily	scrappy
screakily	screaky
screamingly	screaming
scriptural	Scripture
scriptural	script
scrotal	scrotum
scrumptiously	scrumptious
scrupulously	scrupulous
sculptural	sculpture
scurfy	scurf
scurrilously	scurrilous
scurvily	scurvy
scythian	Scythian
scythian	Scythian
searchingly	searching
seasonably	seasonable
seasonably	seasonable
seasonally	seasonal
second hand	secondhand
secondarily	secondary
secondhand	secondhand
secretarial	secretary
secretively	secretive
secretly	secret
secretory	secretion
sectarian	sect
sectional	section
sectorial	sector
secular	secularism
securely	secure
securely	secure
securely	secure
securely	secure
sedimentary	sediment
seductively	seductive
sedulously	sedulous
seemingly	seeming
seismologic	seismology
seismological	seismology
selectively	selective
self	self
self-aggrandising	self-aggrandisement
self-aggrandizing	self-aggrandizement
self-conceitedly	self-conceited
self-consciously	self-conscious
self-evidently	self-evident
self-induced	self-induction
self-indulgently	self-indulgent
self-limited	limit
self-pollinating	self-pollination
self-renewing	self-renewal
self-righteously	self-righteous
self-service	self-service
selfishly	selfish
selflessly	selfless
seljuk	Seljuk
semantic	semantics
semantically	semantic
semi-tuberous	tuber
semiannually	semiannual
semiautobiographical	autobiography
semicentenary	semicentenary
semicentennial	semicentennial
semimonthly	semimonthly
seminal	semen
seminiferous	semen
semiotic	semiotics
semiparasitic	semiparasite
semite	Semite
semiterrestrial	earth
semitic	Semite
semitic	Semitic
semiweekly	semiweekly
senatorial	senator
senecan	Seneca
senegalese	Senegal
sensational	sensation
sensationally	sensational
senselessly	senseless
senselessly	senseless
sensibly	sensible
sensitively	sensitive
sensorimotor	reaction
sensorineural	neural
sensory	sensation
sensually	sensual
sensuously	sensuous
sentential	sentence
sententiously	sententious
sentimentally	sentimental
sepaline	sepal
sepaloid	sepal
separably	separable
separately	separate
septal	septum
septate	septum
septic	decomposition
sepulchral	sepulchre
sequentially	sequential
seraphic	seraph
seraphical	seraph
serbian	Serbia
serbian	Serbian
serenely	serene
serial	serialism
serial	series
serially	serial
sericultural	sericulture
sericultural	sericulture
seriously	serious
seriously	serious
serologic	serology
serological	serology
serous	serum
servilely	servile
servo	servomechanism
servomechanical	servomechanism
seventhly	seventh
severely	severe
severely	severe
severely	severe
sex-limited	sex characteristic
sex-linked	sex linkage
sexagesimal	one-sixtieth
sexual	sex
sexually	sexual
sexually	sexual
seychellois	Seychelles
shabbily	shabby
shabbily	shabby
shaggily	shaggy
shakedown	shakedown
shakespearean	Shakespeare
shakespearian	Shakespeare
shakily	shaky
shakily	shaky
shallow-draft	draft
shallow-draught	draft
shallowly	shallow
shamanist	shamanism
shamanistic	shamanism
shambolic	shambles
shambolically	shambolic
shamefacedly	shamefaced
shamefully	shameful
shamelessly	shameless
shaped	shape
shapelessly	shapeless
sharp-pointed	point
sharply	sharp
sharply	sharp
shavian	Shaw
sheepishly	sheepish
shelflike	shelf
shiftily	shifty
shinto	Shintoism
shintoist	Shintoism
shintoistic	Shintoism
shockingly	shocking
shoddily	shoddy
shona	Shona
short-handled	handle
short-order	short order
shortly	short
shoulder-to-shoulder	close
shouldered	shoulder
showily	showy
showily	showy
shrewdly	shrewd
shrewishly	shrewish
shrilly	shrill
shrubby	shrub
shuha	Shuha Shinto
shyly	shy
siamese	Siam
siamese	Siamese
siamese	Thai
siberian	Siberia
sicilian	Sicily
sickeningly	sickening
side-to-side	side
sidearm	pitch
sidearm	sidearm
sidereal	constellation
sidesplittingly	sidesplitting
sierra leonean	Sierra Leone
sigmoid	curve
sigmoid	sigmoid flexure
sigmoidal	sigmoid flexure
signally	signal
significantly	significant
significantly	significant
significantly	significant
sikh	Sikhism
silently	silent
siliceous	silica
silicious	silica
simian	ape
similarly	similar
simply	simple
simultaneously	simultaneous
sincerely	sincere
sinewy	sinew
singaporean	Singapore
singaporean	Singapore
singaporean	Singapore
singhalese	Sinhalese
singhalese	Sinhalese
single-humped	hump
single-mindedly	single-minded
single-stranded	strand
singly	single
singly	single
singularly	singular
sinhala	Sinhalese
sinhalese	Sinhalese
sinhalese	Sinhalese
sinitic	Chinese
sinuously	sinuous
sinusoidally	sinusoidal
siouan	Siouan
siouan	Sioux
sisyphean	Sisyphus
sixthly	sixth
skeletal	skeleton
sketchily	sketchy
skillfully	skillful
skimpily	skimpy
skinnerian	Skinner
skinny	skin
skittishly	skittish
slackly	slack
slanderously	slanderous
slangily	slangy
slantingly	slanting
slav	Slav
slavic	Slavonic
slavishly	slavish
slavonic	Slavonic
sleekly	sleek
sleepily	sleepy
sleeplessly	sleepless
slenderly	slender
slenderly	slender
slightingly	slighting
slightly	slight
slimly	slim
slivery	sliver
slopingly	sloping
sloppily	sloppy
slouchily	slouchy
slovakian	Slovakia
slovenian	Slovenia
slower	slow
slowest	slow
slowly	slow
slowly	slow
sluggishly	sluggish
slyly	sly
small-cap	market capitalization
small-capitalisation	market capitalisation
small-capitalization	market capitalization
small-mindedly	small-minded
smarmily	smarmy
smartly	clever
smartly	smart
smartly	vigorous
smolderingly	smoldering
smoothly	smooth
smoothly	smooth
smoulderingly	smouldering
smugly	smug
smuttily	smutty
snappishly	snappish
sneakily	sneaky
sneakingly	sneaking
sneeringly	sneering
snidely	snide
snobbishly	snobbish
snootily	snooty
snow-capped	snowcap
snugly	snug
snugly	snug
snugly	snug
soapy	soap
soberly	sober
sociably	sociable
sociably	sociable
social	society
social	society
socially	social
socially	social
societal	society
sociobiologic	sociobiology
sociobiological	sociobiology
sociobiologically	sociobiological
sociocultural	culture
sociocultural	society
socioeconomic	economic
socioeconomically	socioeconomic
sociolinguistic	sociolinguistics
sociolinguistically	sociolinguistic
sociological	sociology
sociologically	sociological
sociopathic	sociopathic personality
socratic	Socrates
soft	soft
soft-finned	soft-finned fish
soft-nosed	bullet
softly	soft
solanaceous	Solanaceae
solar	sun
solely	sole
solemnly	solemn
solicitously	solicitous
solidly	solid
solidly	solid
solitarily	solitary
solomonic	Solomon
somali	Somalia
somalian	Somalia
somatosensory	somatosense
somberly	somber
somnolently	somnolent
sonorously	sonorous
soothingly	soothing
sophistic	sophist
sordidly	sordid
sorely	sore
sorely	sore
sorrowfully	sorrowful
sorrowfully	sorrowful
soteriological	soteriology
sotho	Sotho
sottishly	sottish
soughingly	soughing
soulfully	soulful
soullessly	soulless
soundlessly	soundless
soundly	sound
soundly	sound
sourly	sour
south african	South Africa
south american	South America
south korean	South Korea
southeastward	southeastward
southeastwardly	southeastward
southerly	southerly
southerly	southerly
southwestward	southwestward
southwestwardly	southwestward
soviet	Soviet Union
spacial	space
spaciously	spacious
spanish	Spain
sparely	spare
sparingly	sparing
sparsely	sparse
spartan	Sparta
spasmodically	spasmodic
spasmodically	spasmodic
spastic	spasm
spatial	space
spatially	spacial
spatiotemporal	space-time
specialistic	specialist
specially	special
specially	special
specific	species
specifically	specific
speciously	specious
spectacularly	spectacular
spectral	spectrum
spectrographic	spectrograph
spectrographically	spectrographic
spectrometric	spectrometry
spectroscopic	spectroscopy
spectroscopical	spectroscopy
speculatively	speculative
speechlessly	speechless
speedily	speedy
spermatic	sperm
spermicidal	spermicide
spermous	sperm
spherical	sphere
spherically	spherical
sphingine	sphinx
spicate	spike
spicily	spicy
spinal	spine
spinally	spinal
spiny-finned	spiny-finned fish
spirally	spiral
spiritedly	spirited
spiritualist	spiritualism
spiritualistic	spiritualism
spiritually	spiritual
spitefully	spiteful
spitefully	spiteful
splashy	splash
splendidly	splendid
splendidly	splendid
splenetic	spleen
splenic	spleen
splintery	splinter
spondaic	spondee
spontaneously	spontaneous
sporadically	sporadic
sporogenous	spore
sporting	sport
sportingly	sporting
sportive	sport
sportively	coltish
spotlessly	spotless
spousal	spouse
spousal	wedding
spring-loaded	spring
sprucely	spruce
spuriously	spurious
squalidly	squalid
squarely	square
squarely	square
squeamishly	squeamish
squint-eyed	squint
squinty	squint
sri lankan	Ceylon
stably	stable
stably	stable
stagflationary	stagflation
stagily	stagy
staidly	staid
stainable	stainability
stalinist	Stalin
standoffishly	standoffish
stannic	tin
stannous	tin
staphylococcal	staphylococcus
starkly	stark
starkly	stark
starkly	stark
startlingly	startling
static	static electricity
statistical	statistics
statistically	statistical
statuary	statue
statutorily	statutory
statutory	statute
staunchly	staunch
steadfastly	steadfast
steadily	steady
steadily	steady
stealthily	stealthy
stearic	fat
steeply	steep
stellar	star
stemmatic	stemma
stenographic	stenography
stenographical	stenography
stereoscopic	stereoscope
stereoscopic	stereoscopy
stereotypically	stereotypical
sternal	sternum
sternly	stern
sternutatory	sternutator
steroidal	steroid hormone
stertorously	stertorous
stickily	sticky
stiffly	stiff
stiffly	stiff
stigmatic	stigma
stigmatic	stigmatism
still	still
stiltedly	stilted
stingily	stingy
stingless	sting
stipendiary	stipend
stirringly	stirring
stochastically	stochastic
stockily	stocky
stodgily	stodgy
stoic	Stoicism
stoically	stoic
stoichiometric	stoichiometry
stolidly	stolid
stoloniferous	stolon
stomachal	stomach
stomachic	stomach
stomatal	stoma
stomatal	stoma
stomatous	stoma
stomatous	stoma
stonily	stony
stored-program	stored program
stormily	stormy
stoutly	stout
stovepiped	stovepiping
straight	straight
straightforwardly	straightforward
strangely	strange
strategic	strategy
strategical	strategy
strategically	strategic
stravinskian	Stravinsky
stravinskyan	Stravinsky
strenuously	strenuous
strep	streptococcus
streptococcal	streptococcus
streptococcic	streptococcus
striate	stria
strictly	strict
strictly	strict
stridently	strident
strikingly	striking
stringently	stringent
strongly	strong
strongly	strong
structural	structure
structural	structure
structurally	structural
stubbornly	stubborn
studiously	studious
stuffily	stuffy
stunningly	stunning
stupendously	stupendous
stupidly	stupid
sturdily	sturdy
stylishly	stylish
stylistically	stylistic
suavely	suave
sub-saharan	Sahara
subarctic	Arctic Circle
subatomic	atom
subclavian	clavicle
subclinical	clinical
subconsciously	subconscious
subcortical	cortex
subcutaneous	skin
subcutaneously	subcutaneous
subdural	dura mater
subjectively	subjective
subjunctive	subjunctive mood
sublingual	tongue
sublittoral	continental shelf
sublunar	Moon
sublunary	Moon
submissively	submissive
suborbital	orbit
suborbital	orbit
subsequently	subsequent
subserviently	subservient
substantially	substantial
substantially	substantial
substantival	substantive
subtly	subtle
subtropic	subtropics
subtropical	subtropics
suburban	suburb
successfully	successful
successively	successive
succinctly	succinct
succinic	amber
suctorial	suction
sudanese	Sudan
suddenly	sudden
sudorific	sudation
sudsy	suds
sufficiently	sufficient
sufi	Sufi
sufi	Sufism
suggestively	suggestive
suitably	suitable
sulcate	sulcus
sulfuretted	sulfur
sulfuric	sulfur
sulfurized	sulfur
sulfurous	sulfur
sulkily	sulky
sullenly	sullen
sulphuretted	sulfur
sulphuric	sulfur
sulphurous	sulphur
sultrily	sultry
sumatran	Sumatra
sumerian	Sumer
sumerian	Sumerian
summa cum laude	summa cum laude
summarily	summary
sumptuously	sumptuous
sunnily	sunny
superbly	superb
superciliously	supercilious
superficial	surface
superficially	superficial
superfluously	superfluous
superlatively	superlative
superlunar	Moon
superlunary	Moon
supernaturalist	supernaturalism
supernaturalistic	supernaturalism
supernaturally	supernatural
superstitiously	superstitious
supervisory	supervisor
supinely	supine
supinely	supine
suppurative	suppuration
supraocular	eye socket
supraorbital	eye socket
supremely	supreme
surely	sure
surficial	surface
surgical	surgery
surgically	surgical
surlily	surly
surpassingly	surpassing
surprisedly	surprised
surprisingly	surprising
surprisingly	surprising
surreptitiously	surreptitious
suspiciously	suspicious
sustainable	sustainability
sustentacular	sustainment
swazi	Swaziland
swedish	Sweden
sweepingly	sweeping
sweetly	sweet
swiftly	swift
swiss	Switzerland
syllabic	syllabary
syllabic	syllable
syllabically	syllabic
syllogistic	syllogism
symbiotically	symbiotic
symbolic	symbol
symbolic	symbolism
symbolical	symbol
symbolically	symbolic
symbolically	symbolic
symmetrically	symmetrical
sympathetic	sympathetic nervous system
sympathetically	sympathetic
sympathetically	sympathetic
symphonic	symphony
symptomatic	symptom
symptomatically	symptomatic
synaesthetic	synesthesia
synaptic	synapse
synchronously	synchronous
syncretic	syncretism
syncretic	syncretism
syncretical	syncretism
syncretical	syncretism
syncretistic	syncretism
syncretistic	syncretism
syncretistical	syncretism
syncretistical	syncretism
synergistic	synergism
synergistically	synergistic
synergistically	synergistic
synesthetic	synesthesia
synonymously	synonymous
synoptic	synopsis
synovial	synovia
syntactic	syntax
syntactical	syntax
syntactically	syntactic
syntagmatic	syntagma
synthetically	synthetic
syphilitic	syphilis
syrian	Syria
systematically	systematic
systolic	systole
tabular	table
tacitly	tacit
taciturnly	taciturn
tactfully	tactful
tactical	tactic
tactical	tactics
tactically	tactical
tactile	touch
tactile	touch
tactlessly	tactless
tactual	touch
tactual	touch
tactually	tactual
tahitian	Tahiti
tai	Tai
tai	Thai
tai	Thailand
taiwanese	Taiwan
tajikistani	Tajikistan
talkatively	talkative
talkily	talky
tamely	tame
tamil	Tamil
tamil	Tamil
tangential	tangent
tangentially	tangential
tangibly	tangible
tannic	tannin
tantalizingly	tantalizing
tantric	Tantrism
tantrik	Tantrism
tanzanian	Tanzania
taoist	Taoism
taoist	Taoism
tardily	tardy
tarsal	tarsus
tartaric	tartar
tartly	tart
tasmanian	Tasmania
tastefully	tasteful
tastelessly	tasteless
tastily	tasty
tattily	tatty
taurine	bull
tautly	taut
tawdrily	tawdry
taxonomic	taxonomy
taxonomical	taxonomy
taxonomically	taxonomic
tearfully	tearful
teasingly	teasing
technical	technique
technical	technology
technically	technical
technological	technology
technologically	technological
technophilic	technophilia
technophobic	technophobia
tectonic	tectonics
tectonic	tectonics
tediously	tedious
tegular	tile
telegraphic	telegraph
telegraphically	telegraphic
telemetered	telemetry
teleological	teleology
telephonic	telephone
telescopically	telescopic
tellingly	telling
tellurian	earth
telluric	earth
telluric	tellurium
telocentric	centromere
temperamental	temperament
temperamentally	temperamental
temperately	temperate
temperately	temperate
temporal	temple
temporal	time
temporally	temporal
temporarily	temporary
temptingly	tempting
tenaciously	tenacious
tendentiously	tendentious
tenderly	tender
tendinous	tendon
tendril-climbing	tendril
tensely	tense
tensile	tension
tensional	tension
tentacled	tentacle
tentacular	tentacle
tentatively	tentative
tenthly	tenth
tenuously	tenuous
teratogenic	teratogen
terminal	term
terminal	terminus
terminally	terminal
terminological	terminology
terpsichorean	terpsichore
terrene	earth
terrestrial	Earth
terrestrial	earth
terrestrially	terrestrial
terrestrially	terrestrial
terribly	terrible
terrifically	terrific
territorial	territory
territorially	territorial
tersely	terse
tertian	cycle
tertian	third
testaceous	testa
testamentary	testament
testicular	testis
testily	testy
testimonial	testimonial
testimonial	testimony
tetanic	tetanus
tetanic	tetany
tetchily	tetchy
tetragonal	tetragon
tetrametric	tetrameter
tetravalent	valence
teutonic	Teuton
texan	Texas
textile	fabric
textual	text
thai	Thai
thai	Thai
thai	Thailand
thalamocortical	cortical
thalassic	sea
thalloid	thallus
thallophytic	thallophyte
thankfully	thankful
theatrical	theater
theatrically	theatrical
theatrically	theatrical
theban	Thebes
theban	Thebes
theist	theism
theistic	theism
theistical	theism
thematic	theme
thematic	theme
thematically	thematic
thenal	thenar
thenal	thenar
thenar	thenar
theocratic	theocracy
theological	theology
theologically	theological
theologically	theological
theoretically	theoretical
theoretically	theoretical
theosophical	theosophy
therapeutic	therapy
therapeutical	therapy
therapeutically	therapeutic
thermal	heat
thermal	hot spring
thermally	thermal
thermic	heat
thermionic	thermion
thermodynamic	thermodynamics
thermodynamical	thermodynamics
thermodynamically	thermodynamic
thermoelectric	thermoelectricity
thermoelectrical	thermoelectricity
thermogravimetric	hydrometric
thermohydrometric	hydrometric
thermometric	thermometry
thermostatic	thermostat
thermostatically	thermostatic
thespian	drama
thickly	thick
thickly	thick
thickly	thick
thickly	thick
thievishly	thievish
thinly	thin
thinly	thin
thinly	thin
thinly	thin
thirdhand	thirdhand
thirstily	thirsty
thirstily	thirsty
thoracic	chest
thoreauvian	Thoreau
thoroughly	thorough
thoroughly	thorough
thoughtfully	thoughtful
thoughtfully	thoughtful
thoughtlessly	thoughtless
thoughtlessly	thoughtless
thracian	Thrace
threaded	screw thread
threateningly	threatening
three-wheel	wheel
three-wheeled	wheel
thriftily	thrifty
thriftlessly	thriftless
thyroid	thyroid gland
thyroid	thyroid gland
thyroidal	thyroid gland
thyrotoxic	thyrotoxicosis
tibetan	Tibet
tibial	tibia
tidal	tide
tidily	tidy
tiered	tier
tightly	tight
tightly	tight
time-release	release
timidly	timid
timorese	Timor
timorously	timorous
tinny	tin
tiredly	tired
tirelessly	tireless
tiresomely	tiresome
titular	title
titular	title
titular	title
titular	title
titulary	title
tobagonian	Tobago
togolese	Togo
tolerably	tolerable
tolerantly	tolerant
toll-free	toll
tomentose	tomentum
tonal	tone
tonelessly	toneless
tongan	Tonga
tonic	tone
tonic	tonus
tonsorial	barber
topical	topic
topically	topical
topographic	topography
topographical	topography
topographically	topographical
topologic	topology
topological	topology
topologically	topological
toppingly	topping
toroidal	toroid
torpidly	torpid
torrential	torrent
tortious	tort
torturously	torturous
totalistic	totalism
totalitarian	totalitarianism
totally	total
totemic	totemism
totipotent	totipotency
touchily	touchy
touchingly	touching
toughly	tough
toxicologic	toxicology
toxicological	toxicology
trabecular	trabecula
trabeculate	trabecula
tracheal	trachea
tractive	traction
traditionally	traditional
tragic	tragedy
tragically	tragic
tragicomic	tragicomedy
traitorously	traitorous
tranquilly	tranquil
transactinide	transactinide
transatlantic	Atlantic
transcendental	transcendentalism
transcendentally	transcendental
transcultural	culture
transcutaneous	skin
transdermal	dermis
transdermic	dermis
transiently	transient
transitional	transition
transitionally	transitional
transitively	transitive
transitorily	transitory
translational	translation
translunar	Moon
translunary	Moon
transoceanic	ocean
transparently	transparent
transparently	transparent
transpolar	pole
transuranic	uranium
transversally	transversal
transversely	transverse
trapezoidal	trapezoid
traumatic	trauma
treacherously	treacherous
treasonably	treasonable
tremendously	tremendous
tremulously	tremulous
trenchantly	trenchant
trepidly	trepid
triangulate	triangle
triassic	Triassic
tribal	tribe
tricentenary	tercentenary
tricentenary	tercentennial
tricentenary	triennial
tricentennial	tercentenary
tricentennial	tercentennial
tricentennial	triennial
trickily	tricky
trigonometric	trigonometry
trihydroxy	hydroxyl
trimly	trim
trinidadian	Trinidad
trippingly	tripping
tritely	trite
triumphal	triumph
triumphantly	triumphant
trivalent	valence
trivially	trivial
trochaic	trochee
trojan	Troy
trophic	nutrition
trophoblastic	trophoblast
trophotropic	trophotropism
tropical	tropic
tropically	tropical
truculently	truculent
truly	true
truly	true
truly	true
trustfully	trustful
trustfully	trustful
trustingly	trusting
truthfully	truthful
tsarist	czar
tsaristic	czar
tubal	tube
tubercular	tubercle
tubercular	tuberculosis
tubercular	tuberosity
tuberculate	tubercle
tuberculoid	tuberculosis
tuberous	tuber
tudor	Tudor
tumultuously	tumultuous
tunefully	tuneful
tunelessly	tuneless
tunisian	Tunis
tunisian	Tunisia
turbinate	turbinate bone
turbulently	turbulent
turgidly	turgid
turkic	Turki
turkish	Turkey
turkmen	Turkmenistan
tuscan	Tuscany
tutorial	tutor
tutorially	tutorial
two-humped	hump
two-wheel	wheel
two-wheeled	wheel
tympanic	tympani
tympanic	tympanum
tympanitic	tympanites
typically	typical
typographic	typography
typographical	typography
typographically	typographic
tyrolean	Tyrol
tyrolese	Tyrol
tzarist	czar
ugandan	Uganda
ukrainian	Ukraine
ulcerative	ulceration
ulnar	ulna
ulteriorly	ulterior
ultimately	ultimate
ultramicroscopic	ultramicroscope
ultramontane	ultramontanism
ultrasonically	ultrasonic
umbellar	umbel
umbellate	umbel
umbelliferous	Umbelliferae
umbelliform	umbel
umbilical	umbilicus
unabashedly	unabashed
unacceptably	acceptable
unaccompanied	unaccompanied
unaccountably	unaccountable
unachievably	unachievable
unadvisedly	unadvised
unalterably	unalterable
unambiguously	unambiguous
unambitiously	unambitious
unanimously	unanimous
unappealingly	unappealing
unappreciatively	unappreciative
unarguably	unarguable
unashamedly	unashamed
unassailably	unassailable
unassertively	unassertive
unassumingly	unassuming
unattainably	unattainable
unattractively	unattractive
unavoidably	unavoidable
unbecomingly	unbecoming
unbelievably	unbelievable
unbelievably	unbelievable
unbelievingly	unbelieving
unblinkingly	unblinking
unblushingly	unblushing
uncannily	uncanny
unceasingly	unceasing
unceremoniously	unceremonious
uncertainly	uncertain
uncertainly	uncertain
unchangeably	unchangeable
uncharacteristically	uncharacteristic
unchivalrously	unchivalrous
uncial	uncial
uncivilly	uncivil
unclearly	unclear
unclearly	unclear
uncomfortably	uncomfortable
uncommonly	uncommon
uncomplainingly	uncomplaining
uncompromisingly	uncompromising
unconcernedly	unconcerned
unconditionally	unconditional
unconsciously	unconscious
unconstitutionally	unconstitutional
uncontrollably	uncontrolled
uncontroversially	uncontroversial
unconventionally	unconventional
unconvincingly	unconvincing
uncouthly	uncouth
uncritically	uncritical
unctuously	unctuous
undecipherably	undecipherable
undemocratically	undemocratic
undeniably	undeniable
undependably	undependable
under way	moving
underhandedly	underhand
understandably	comprehensible
understandingly	understanding
undescended	undescended testicle
undeservedly	undeserved
undesirably	undesirable
undiplomatically	diplomatic
undisputedly	undisputed
undramatically	undramatic
undulant	undulation
undulatory	undulation
unduly	undue
uneasily	uneasy
unemotionally	unemotional
unendingly	unending
unenthusiastically	unenthusiastic
unequally	unequal
unequivocally	unequivocal
unerringly	unerring
unethically	unethical
unevenly	uneven
unevenly	uneven
uneventfully	uneventful
unexcitingly	unexciting
unexpectedly	unexpected
unexpectedly	unexpected
unfailingly	unfailing
unfairly	unfair
unfaithfully	unfaithful
unfalteringly	unfaltering
unfashionably	unfashionable
unfavorably	unfavorable
unfeelingly	unfeeling
unfeelingly	unfeeling
unfeignedly	unfeigned
unforgettably	unforgettable
unforgivably	unforgivable
unforgivingly	unforgiving
unfortunately	unfortunate
unfretted	fret
ungracefully	ungraceful
ungrammatically	ungrammatical
ungratefully	ungrateful
ungrudgingly	ungrudging
ungual	claw
ungual	hoof
ungual	nail
unhappily	unhappy
unhelpfully	unhelpful
unhesitatingly	unhesitating
unhurriedly	unhurried
unhygienically	unhygienic
uniate	Uniate Church
unicellular	cell
unifilar	filar
uniformly	uniform
unilaterally	unilateral
unimaginably	unimaginable
unimaginatively	unimaginative
unimpeachably	unimpeachable
unimpressively	unimpressive
uninformatively	uninformative
uninstructively	uninstructive
unintelligently	unintelligent
unintelligibly	unintelligible
unintentionally	unintentional
uninterestingly	uninteresting
uninterruptedly	uninterrupted
uninucleate	nucleus
uninvitedly	uninvited
uniovular	ovule
uniovulate	ovule
uniquely	unique
unitarian	Unitarianism
unitary	unit
unitary	unity
universalist	universalism
universalistic	universalism
universalistic	whole
unjustifiably	unjustifiable
unjustly	unjust
unkindly	unkind
unlawfully	unlawful
unluckily	unlucky
unmanageably	unmanageable
unmanfully	unmanful
unmelodiously	unmelodious
unmemorably	unmemorable
unmercifully	unmerciful
unmindfully	unmindful
unmistakably	unmistakable
unmusically	unmusical
unmyelinated	myelin
unnaturally	unnatural
unnaturally	unnatural
unnecessarily	unnecessary
unnecessarily	unnecessary
unnoticeably	unnoticeable
unobtrusively	unobtrusive
unofficially	unofficial
unofficially	unofficial
unoriginally	unoriginal
unpalatably	unpalatable
unpardonably	unpardonable
unpatriotically	unpatriotic
unpigmented	pigmentation
unpleasantly	unpleasant
unprecedentedly	unprecedented
unpredictably	unpredictable
unpretentiously	unpretentious
unproductively	unproductive
unprofitably	unprofitable
unprofitably	unprofitable
unpropitiously	unpropitious
unqualifiedly	unqualified
unquestionably	unquestionable
unquestionably	unquestionable
unquestioningly	unquestioning
unquietly	unquiet
unreadably	unreadable
unrealistically	unrealistic
unreasonably	unreasonable
unreasonably	unreasonable
unrecognizably	unrecognizable
unrelentingly	unrelenting
unreliably	unreliable
unremarkably	unremarkable
unrepentantly	unrepentant
unreproducibly	unreproducible
unrestrainedly	unrestrained
unrighteously	unrighteous
unsatisfactorily	unsatisfactory
unscientifically	unscientific
unscrupulously	unscrupulous
unseasonably	unseasonable
unselfconsciously	unselfconscious
unselfishly	unselfish
unsentimentally	unsentimental
unshakably	unshakable
unsmilingly	unsmiling
unsociably	unsociable
unsparingly	unsparing
unspeakably	unspeakable
unsportingly	unsporting
unsteadily	unsteady
unstintingly	unstinting
unsuccessfully	unsuccessful
unsuspectingly	unsuspecting
unswervingly	unswerving
unswervingly	unswerving
unsympathetically	unsympathetic
unsystematically	unsystematic
unthematic	theme
unthinkably	unthinkable
unthinkingly	unthinking
untidily	untidy
untimely	untimely
untruly	untrue
untruthfully	untruthful
untypically	untypical
unusually	unusual
unutterably	unutterable
unwantedly	unwanted
unwarily	unwary
unwarrantably	unwarrantable
unwaveringly	unwavering
unwillingly	unwilling
unwittingly	unwitting
unwontedly	unwonted
unworthily	unworthy
uppishly	uppish
uprightly	upright
uprightly	upright
uproariously	uproarious
urban	city
urbanely	urbane
urceolate	urceole
uremic	uremia
urethral	urethra
urgently	urgent
uric	urine
uricosuric	urine
urinary	urinary system
urinary	urine
urogenital	urogenital system
ursine	bear
uruguayan	Uruguay
usefully	useful
uselessly	useless
usually	usual
usufructuary	usufruct
usuriously	usurious
uterine	uterus
utopian	Utopia
utopian	utopia
utterly	utter
uveal	uvea
uveous	uvea
uvular	uvula
uxoriously	uxorious
uzbekistani	Uzbekistan
vacantly	vacant
vacuolate	vacuole
vacuolated	vacuole
vacuously	vacuous
vagal	vagus
vaginal	vagina
vaguely	vague
vainly	vain
valedictory	valediction
valent	valence
valetudinarian	valetudinarian
valetudinary	valetudinarian
valiantly	valiant
validly	valid
valorously	valorous
valved	valve
valvular	valve
vanilla	vanilla
vapidly	vapid
variably	variable
varicelliform	varicella
variolar	variola
variolic	variola
variolous	variola
variously	various
vascular	vessel
vasomotor	vasoconstriction
vasomotor	vasodilation
vastly	vast
vedic	Veda
vegetative	vegetation
vegetive	vegetation
vehemently	vehement
vehicular	vehicle
veinal	vein
velar	velum
venally	venal
venetian	Venice
venezuelan	Venezuela
vengefully	vengeful
venomously	venomous
venous	vein
ventilatory	ventilation
ventrally	ventral
ventricular	ventricle
ventricular	ventricle
verbal	verb
verbal	word
verbally	verbal
verbally	verbal
verbosely	verbose
vertebral	vertebra
vertical	vertical integration
vertically	vertical
vesical	vesica
vesicular	vesicle
vestal	Vesta
vestiary	clothing
vestibular	vestibular sense
vestmental	vestment
veterinary	veterinarian
veterinary	veterinary medicine
vexatiously	vexatious
viatical	viatication
vibrational	vibration
vibrionic	genus Vibrio
vicarial	vicar
vicariously	vicarious
vice-presidential	vice president
vicennial	twenty
viceregal	viceroy
vicinal	vicinity
viciously	vicious
victorian	Victoria
victorian	Victorian age
victoriously	victorious
viennese	Vienna
vietnamese	Vietnam
vietnamese	Vietnamese
vietnamese	Vietnamese
vigesimal	twenty
vigilantly	vigilant
vigorously	vigorous
vilely	vile
vinaceous	wine
vindictively	vindictive
vinous	wine
violently	violent
viral	virus
virginal	virginity
viricidal	viricide
virological	virology
virtually	virtual
virtuously	virtuous
virtuously	virtuous
virucidal	virucide
virulently	virulent
visceral	viscera
viscerally	visceral
viscerally	visceral
viscidly	viscid
viscometric	viscometer
viscosimetric	viscosimeter
visibly	visible
visibly	visible
visual	sight
vitally	vital
vitiliginous	vitiligo
vitreous	glass
vitreous	vitreous humor
vitriolically	vitriolic
vivaciously	vivacious
vividly	vivid
vocal	voice
vocal	voice
vocalic	vowel
vocally	vocal
vocational	vocation
vocationally	vocational
vocative	vocative
vociferously	vociferous
volar	palm
volar	sole
volcanic	volcano
volcanically	volcanic
volitionally	volitional
voltaic	voltage
voltarean	Voltaire
voltarian	Voltaire
volubly	voluble
volumed	volume
volumetric	volumeter
volumetrical	volumeter
volumetrically	volumetric
voluntarily	voluntary
voluptuously	voluptuous
voluptuously	voluptuous
voraciously	voracious
voyeuristic	voyeur
voyeuristic	voyeurism
voyeuristical	voyeur
voyeuristical	voyeurism
voyeuristically	voyeuristic
vulgarly	vulgar
vulnerably	vulnerable
vulpecular	fox
vulpine	fox
vulval	vulva
vulvar	vulva
wackily	wacky
wafer-thin	wafer-thin
waggishly	waggish
wagnerian	Wagner
wanly	wan
wantonly	wanton
wantonly	wanton
warily	wary
warm	warm
warmly	warm
warmly	warm
washingtonian	Washington
washingtonian	Washington
washingtonian	Washington
washingtonian	Washington
wastefully	wasteful
watchfully	watchful
waxen	wax
waxy	wax
weakly	weak
wealthily	wealthy
wearily	weary
weatherly	weatherliness
wedge-shaped	wedge
weightily	weighty
weightily	weighty
weirdly	weird
welsh	Wales
west african	West Africa
westerly	west
westerly	west
wheaten	wheat
wheezily	wheezy
wheezingly	wheezing
whiplike	whip
whole-wheat	wheat
wholeheartedly	wholehearted
wholemeal	wheat
wholesomely	wholesome
wholly	whole
wiccan	Wicca
wickedly	wicked
wide-angle	wide-angle lens
wideband	frequency band
wild	wild
wildly	wild
wildly	wild
wildly	wild
wilfully	wilful
willfully	willful
willingly	willing
wilsonian	Wilson
windily	windy
winsomely	winsome
wiry	wire
wisely	wise
wishfully	wishful
wistfully	wistful
witheringly	withering
wittgensteinian	Wittgenstein
wittily	witty
wittingly	witting
woefully	woeful
wolfish	wolf
wolfishly	wolfish
wolflike	wolf
wonderfully	wonderful
wonderingly	wondering
wondrously	wondrous
woodenly	wooden
woolen	wool
woollen	wool
word-blind	word blindness
wordily	wordy
wordlessly	wordless
wordsworthian	Wordsworth
worriedly	worried
worryingly	worrying
worthily	worthy
worthlessly	worthless
wrathfully	wrathful
wretchedly	wretched
wrinkle-resistant	wrinkle
wrinkleproof	wrinkle
wrongfully	wrongful
wrongheadedly	wrongheaded
wrongly	wrong
wrongly	wrong
wryly	wry
wysiwyg	word processor
x-linked	X chromosome
xerographic	xerography
yeastlike	yeast
yeasty	yeast
yeatsian	Yeats
yemeni	Yemen
yieldingly	yielding
yogic	yoga
yogistic	yoga
youthfully	youthful
yugoslav	Yugoslavia
yugoslavian	Yugoslavia
yuman	Yuma
zairean	Zaire
zairese	Zaire
zambian	Zambia
zapotec	Zapotec
zealously	zealous
zenithal	zenith
zero	null set
zestfully	zestful
zestily	zesty
zimbabwean	Zimbabwe
zionist	Zionism
zionist	Zionist
zodiacal	zodiac
zoic	animal
zolaesque	Zola
zonal	zone
zoological	animal
zoological	zoology
zoonotic	zoonosis
zoroastrian	Zoroaster
zygomatic	cheek
zygotic	zygote
zymoid	enzyme
zymolytic	zymosis
zymotic	zymosis
zymotic	zymosis
